effect	bonus_value_id	unit_ability
#effect_bonus_value_unit_ability_junctions_tables;0;db/effect_bonus_value_unit_ability_junctions_tables/rhox_nagash		
nag_spell_nagash_enable_abyssal_swarm	enable	wh_main_spell_nagash_abyssal_swarm
nag_spell_nagash_enable_abyssal_swarm_upgrade	enable	wh_main_spell_nagash_abyssal_swarm
nag_spell_nagash_enable_abyssal_swarm_upgrade	enable_overchage	wh_main_spell_nagash_abyssal_swarm
nag_spell_nagash_cooldown_abyssal_swarm	recharge_mod	wh_main_spell_nagash_abyssal_swarm
nag_spell_nagash_miscast_reduction_abyssal_swarm_upgraded	miscast_percentage_mod	wh_main_spell_nagash_abyssal_swarm_upgrade
nag_spell_nagash_reduce_wom_cost_abyssal_swarm	cost_mod	wh_main_spell_nagash_abyssal_swarm
nag_spell_nagash_reduce_wom_cost_abyssal_swarm_upgraded	cost_mod	wh_main_spell_nagash_abyssal_swarm_upgrade
nag_effect_ability_uses_abyssal_swarm	uses_mod	wh_main_spell_nagash_abyssal_swarm
nag_effect_ability_uses_abyssal_swarm	uses_mod	wh_main_spell_nagash_abyssal_swarm_upgrade
nag_spell_nagash_enable_breath_of_darkness	enable	wh_main_spell_nagash_breath_of_darkness
nag_spell_nagash_enable_breath_of_darkness_upgrade	enable	wh_main_spell_nagash_breath_of_darkness
nag_spell_nagash_enable_breath_of_darkness_upgrade	enable_overchage	wh_main_spell_nagash_breath_of_darkness
nag_spell_nagash_cooldown_breath_of_darkness	recharge_mod	wh_main_spell_nagash_breath_of_darkness
nag_spell_nagash_miscast_reduction_breath_of_darkness_upgraded	miscast_percentage_mod	wh_main_spell_nagash_breath_of_darkness_upgraded
nag_spell_nagash_reduce_wom_cost_breath_of_darkness	cost_mod	wh_main_spell_nagash_breath_of_darkness
nag_spell_nagash_reduce_wom_cost_breath_of_darkness_upgraded	cost_mod	wh_main_spell_nagash_breath_of_darkness_upgraded
nag_spell_nagash_enable_soul_stealer	enable	wh_main_spell_nagash_soul_stealer
nag_spell_nagash_reduce_wom_cost_soul_stealer	cost_mod	wh_main_spell_nagash_soul_stealer
nag_spell_nagash_enable_dark_riders	enable	wh_main_spell_nagash_dark_riders
nag_spell_nagash_enable_dark_riders_upgrade	enable	wh_main_spell_nagash_dark_riders
nag_spell_nagash_enable_dark_riders_upgrade	enable_overchage	wh_main_spell_nagash_dark_riders
nag_spell_nagash_cooldown_dark_riders	recharge_mod	wh_main_spell_nagash_dark_riders
nag_spell_nagash_miscast_reduction_dark_riders_upgraded	miscast_percentage_mod	wh_main_spell_nagash_dark_riders_upgraded
nag_spell_nagash_reduce_wom_cost_dark_riders	cost_mod	wh_main_spell_nagash_dark_riders
nag_spell_nagash_reduce_wom_cost_dark_riders_upgraded	cost_mod	wh_main_spell_nagash_dark_riders_upgraded
nag_spell_nagash_ability_uses_dark_riders	uses_mod	wh_main_spell_nagash_dark_riders
nag_spell_nagash_ability_uses_dark_riders	uses_mod	wh_main_spell_nagash_dark_riders_upgraded
nag_spell_nagash_enable_grave_call_master	enable	wh_main_spell_nagash_grave_call_master
nag_spell_nagash_enable_grave_call_master_hidden	enable	wh_main_spell_nagash_grave_call_hidden_dummy
nag_spell_nagash_enable_grave_call_master_upgrade	enable	wh_main_spell_nagash_grave_call_master
nag_spell_nagash_enable_grave_call_master_upgrade	enable_overchage	wh_main_spell_nagash_grave_call_master
nag_spell_nagash_cooldown_grave_call_master	recharge_mod	wh_main_spell_nagash_grave_call_master
nag_spell_nagash_miscast_reduction_grave_call_master_upgraded	miscast_percentage_mod	wh_main_spell_nagash_grave_call_master_upgraded
nag_spell_nagash_reduce_wom_cost_grave_call_master	cost_mod	wh_main_spell_nagash_grave_call_master
nag_spell_nagash_reduce_wom_cost_grave_call_master_upgraded	cost_mod	wh_main_spell_nagash_grave_call_master_upgraded
nag_spell_nagash_ability_uses_grave_call_master	uses_mod	wh_main_spell_nagash_grave_call_master
nag_spell_nagash_ability_uses_grave_call_master	uses_mod	wh_main_spell_nagash_grave_call_master_upgraded
nag_spell_nagash_ability_uses_grave_call_master_hidden	uses_mod	wh_main_spell_nagash_grave_call_hidden_dummy
nag_spell_nagash_enable_hand_of_dust	enable	wh_main_spell_nagash_hand_of_dust
nag_spell_nagash_reduce_wom_cost_hand_of_dust	cost_mod	wh_main_spell_nagash_hand_of_dust
nag_spell_nagash_ability_uses_hand_of_dust	uses_mod	wh_main_spell_nagash_hand_of_dust
nag_spell_nagash_enable_harbinger	enable	wh_main_spell_nagash_harbinger
nag_spell_nagash_enable_harbinger_upgrade	enable	wh_main_spell_nagash_harbinger
nag_spell_nagash_enable_harbinger_upgrade	enable_overchage	wh_main_spell_nagash_harbinger
nag_spell_nagash_cooldown_harbinger	recharge_mod	wh_main_spell_nagash_harbinger
nag_spell_nagash_ability_uses_harbinger	uses_mod	wh_main_spell_nagash_harbinger
nag_spell_nagash_miscast_reduction_harbinger	miscast_percentage_mod	wh_main_spell_nagash_harbinger
nag_spell_nagash_reduce_wom_cost_harbinger	cost_mod	wh_main_spell_nagash_harbinger
nag_spell_nagash_reduce_wom_cost_harbinger_upgraded	cost_mod	wh_main_spell_nagash_harbinger_upgraded
nag_effect_enable_bound_spell_nagash_dark_riders	enable	nag_bound_spell_nagash_dark_riders
nag_effect_enable_bound_spell_nagash_hand_of_dust	enable	nag_bound_spell_nagash_hand_of_dust
nag_effect_enable_bound_spell_nagash_breath_of_darkness	enable	nag_bound_spell_nagash_breath_of_darkness
nag_effect_enable_bound_spell_nagash_abyssal_swarm	enable	nag_bound_spell_nagash_abyssal_swarm
nag_effect_enable_bound_spell_nagash_soul_stealer	enable	nag_bound_spell_nagash_soul_stealer
nag_effect_enable_bound_spell_death_purple_sun	enable	nag_bound_spell_death_purple_sun
nag_effect_enable_bound_spell_death_soulblight	enable	wh2_dlc10_spell_bound_soulblight
nag_effect_enable_bound_spell_light_banishment	enable	nag_bound_spell_light_banishment
nag_effect_enable_bound_spell_light_phas_protection	enable	nag_bound_spell_light_phas_protection
nag_effect_enable_bound_spell_vamp_wind_of_death	enable	nag_bound_spell_vamp_wind_of_death
nag_effect_enable_bound_spell_vamp_curse_of_years	enable	nag_bound_spell_vamp_curse_of_years
nag_effect_enable_bound_spell_nehek_cursed_blades	enable	nag_bound_spell_nehek_cursed_blades
nag_effect_enable_bound_spell_nehek_skullstorm	enable	nag_bound_spell_nehek_skullstorm
nag_effect_enable_bound_spell_deep_krakens_pull	enable	nag_bound_spell_deep_krakens_pull
nag_effect_self_enable_ability_mortarch_of_despair	enable	nag_krell_passive_mortarch_of_despair
nag_effect_self_enable_ability_armour_of_barrow	enable	nag_krell_armour_passive_armour_of_barrow
nag_effect_self_arkhan_enable_mortarch_of_sacrements_summon	enable	nag_arkhan_abilities_mortarch_of_sacraments_swarm
nag_effect_self_neferata_enable_ability_blood_queen	enable	nag_neferata_passive_blood_queen
nag_effect_self_neferata_enable_ability_mortarch_of_blood	enable	nag_neferata_abilities_mortarch_of_blood_death
nag_effect_item_neferata_ability_enable_staff_of_pain	enable	nag_neferata_item_passive_staff_of_pain
nag_effect_item_neferata_ability_dagger_of_jet	enable	nag_neferata_item_passive_dagger_of_jet
nag_effect_number_uses_mortarch_of_sacrements	uses_mod	nag_arkhan_abilities_mortarch_of_sacraments_swarm
nag_effect_self_vlad_enable_mortarch_of_shadows_aura	enable	nag_vlad_passive_mortarch_of_shadows_aura
nag_effect_self_vlad_ability_upgrade_mortarch_of_shadows	enable	nag_vlad_passive_mortarch_of_shadows_aura_upgrade
nag_effect_ability_enable_eternal_danse_macabre	enable	nag_nagash_passive_eternal_danse_macabre
nag_effect_ability_enable_malediction_of_nagash	enable	nag_nagash_passive_malediction_of_nagash
nag_effect_ability_enable_raise_the_dead	enable	wh_main_lore_nagash_raise_the_dead
nag_effect_nagash_enable_death_magic_incarnate	enable	nag_nagash_passive_death_magic_incarnate
nag_effect_item_nagash_ability_enable_morikhane	enable	nag_nagash_abilities_morikhane_black_armour
nag_effect_item_nagash_ability_enable_mortis_blade	enable	nag_nagash_abilities_mortis_blade
nag_effect_item_nagash_ability_enable_staff_of_power	enable	nag_nagash_abilities_staff_of_power
nag_effect_item_nagash_ability_enable_crown_of_nagash	enable	nag_nagash_abilities_crown_of_sorcery
nag_effect_item_nagash_ability_enable_ashes_and_dust	enable	nag_nagash_abilities_ashes_and_dust
nag_effect_ability_enable_exorcism_hidden	enable	wh_main_lore_passive_exorcism
nag_effect_ability_enable_the_restless_dead_hidden	enable	wh2_dlc09_lore_passive_the_restless_dead
nag_effect_ability_enable_curse_of_undeath_hidden	enable	wh_main_lore_passive_the_curse_of_undeath
nag_effect_ability_enable_life-leeching_hidden	enable	wh_main_lore_passive_life_leeching
nag_effect_ability_enable_master_arcane_conduit	disable	wh_main_character_abilities_arcane_conduit
nag_effect_ability_enable_master_arcane_conduit	disable	wh2_main_character_passive_grand_arcane_conduit
nag_effect_ability_enable_master_arcane_conduit	enable	nag_nagash_abilities_master_arcane_conduit
nag_effect_enable_heralds_of_the_accursed_one	enable	nag_unit_abilities_heralds_of_the_accursed_one
nag_effect_ability_enable_whispers	enable	nag_azhag_abilities_reckless_whispers
nag_effect_enable_bound_raise_dead_zombie	enable	nag_bound_spell_raise_dead_zombie
nag_effect_enable_bound_raise_dead_reapers	enable	nag_bound_spell_raise_dead_reapers
nag_effect_enable_bound_raise_dead_crypt_ghoul	enable	nag_bound_spell_raise_dead_crypt_ghouls
nag_effect_enable_bound_raise_dead_cairn_wraiths	enable	nag_bound_spell_raise_dead_cairn_wraiths
nag_effect_enable_bound_raise_dead_fell_bats	enable	nag_bound_spell_raise_dead_fell_bats
nag_effect_enable_bound_raise_dead_corpse_cart_balefire	enable	nag_bound_spell_raise_dead_corpse_cart_balefire
nag_effect_enable_bound_raise_dead_corpse_cart_lodestone	enable	nag_bound_spell_raise_dead_corpse_cart_lodestone
