key	text	tooltip
#Loc;1;text/db/nag_effects_caps.loc		
effects_description_nag_effect_unit_cap_nagashi_guard	Unit capacity: %+n\\nNagashizzar Guard	true
effects_description_nag_effect_unit_cap_nagashi_guard_halb	Unit capacity: %+n\\nNagashizzar Guard (Halberds)	true
effects_description_nag_effect_unit_cap_bone_golems	Unit capacity: %+n\\nBone Golems	true
effects_description_nag_effect_unit_cap_morghasts	Unit capacity: %+n\\nMorghasts	true
effects_description_nag_effect_unit_cap_sand_crawlies	Unit capacity: %+n\\nSand Crawlers	true
effects_description_nag_effect_unit_cap_warp_ghouls	Unit capacity: %+n\\nGlowing Ghouls	true
effects_description_nag_effect_unit_cap_carrion_riders	Unit capacity: %+n\\nCarrion Riders	true
effects_description_nag_effect_unit_cap_mortis_engine	Unit capacity: %+n\\nMortis Engine	true
effects_description_nag_effect_unit_cap_spectre_swarm	Unit capacity: %+n\\nFell Spectres	true
effects_description_nag_effect_unit_cap_spirit_hosts	Unit capacity: %+n\\nSpirit Hosts	true
effects_description_nag_effect_unit_cap_bone_thrower	Unit capacity: %+n\\nBone Thrower	true
effects_description_nag_effect_unit_cap_bone_giant_0	Unit capacity: %+n\\nBone Giant	true
effects_description_nag_effect_unit_cap_dire_wolves	Unit capacity: %+n\\nDire Wolves	true
effects_description_nag_effect_unit_cap_fell_bats	Unit capacity: %+n\\nFell Bats	true
effects_description_nag_effect_unit_cap_sepulchral_stalkers_0	Unit capacity: %+n\\nSepulchral Stalkers	true
effects_description_nag_effect_unit_cap_hexwraiths	Unit capacity: %+n\\nHexwraiths	true
effects_description_nag_effect_unit_cap_skeleton_horsemen_0	Unit capacity: %+n\\nSkeleton Horsemen	true
effects_description_nag_effect_unit_cap_skeleton_horsemen_archers_0	Unit capacity: %+n\\nSkeleton Horse Archers	true
effects_description_nag_effect_unit_cap_skeleton_chariot_0	Unit capacity: %+n\\nSkeleton Chariots	true
effects_description_nag_effect_unit_cap_skeleton_archer_chariot_0	Unit capacity: %+n\\nSkeleton Archer Chariots	true
effects_description_nag_effect_unit_cap_necropolis_knights_0	Unit capacity: %+n\\nNecropolis Knights	true
effects_description_nag_effect_unit_cap_necropolis_knights_1	Unit capacity: %+n\\nNecropolis Knights (Halberds)	true
effects_description_nag_effect_unit_cap_screaming_skull_catapult_0	Unit capacity: %+n\\nScreaming Skull Catapults	true
effects_description_nag_effect_unit_cap_casket_of_souls_0	Unit capacity: %+n\\nCasket of Souls	true
effects_description_nag_effect_unit_cap_ushabti_0	Unit capacity: %+n\\nUshabti	true
effects_description_nag_effect_unit_cap_ushabti_1	Unit capacity: %+n\\nUshabti (Great Bow)	true
effects_description_nag_effect_unit_cap_tomb_scorpion_0	Unit capacity: %+n\\nTomb Scorpion	true
effects_description_nag_effect_unit_cap_necrosphinx_0	Unit capacity: %+n\\nNecrosphinx	true
effects_description_nag_effect_unit_cap_nehekhara_horsemen_0	Unit capacity: %+n\\nNehekhara Horsemen	true
effects_description_nag_effect_unit_cap_nehekhara_warriors_0	Unit capacity: %+n\\nNehekhara Warriors	true
effects_description_nag_effect_unit_cap_khemrian_warsphinx_0	Unit capacity: %+n\\nKhemrian Warsphinx	true
effects_description_nag_effect_unit_cap_tomb_guard_0	Unit capacity: %+n\\nTomb Guard	true
effects_description_nag_effect_unit_cap_tomb_guard_1	Unit capacity: %+n\\nTomb Guard (Halberds)	true
effects_description_nag_effect_unit_cap_cairn_wraiths	Unit capacity: %+n\\nCairn Wraiths	true
effects_description_nag_effect_unit_cap_crypt_ghouls	Unit capacity: %+n\\nCrypt Ghouls	true
effects_description_nag_effect_unit_cap_grave_guard_0	Unit capacity: %+n\\nGrave Guard	true
effects_description_nag_effect_unit_cap_grave_guard_1	Unit capacity: %+n\\nGrave Guard (Great Weapons)	true
effects_description_nag_effect_unit_cap_vargheists	Unit capacity: %+n\\nVargheists	true
effects_description_nag_effect_unit_cap_crypt_horrors	Unit capacity: %+n\\nCrypt Horrors	true
effects_description_nag_effect_unit_cap_varghulf	Unit capacity: %+n\\nVarghulf	true
effects_description_nag_effect_unit_cap_blood_knights_0	Unit capacity: %+n\\nBlood Knights	true
effects_description_nag_effect_unit_cap_black_knights_0	Unit capacity: %+n\\nBlack Knights	true
effects_description_nag_effect_unit_cap_black_knights_3	Unit capacity: %+n\\nBlack Knights (Lances & Barding)	true
effects_description_nag_effect_unit_cap_corpse_cart_1	Unit capacity: %+n\\nCorpse Cart (Balefire)	true
effects_description_nag_effect_unit_cap_corpse_cart_2	Unit capacity: %+n\\nCorpse Cart (Unholy Lodestone)	true
effects_description_nag_effect_unit_cap_bloated_corpse_0	Unit capacity: %+n\\nBloated Corpse	true
effects_description_nag_effect_unit_cap_zombie_gunnery_mob_1	Unit capacity: %+n\\nZombie Pirate Gunnery Mob (Handguns)	true
effects_description_nag_effect_unit_cap_deck_gunners_0	Unit capacity: %+n\\nDeck Gunners	true
effects_description_nag_effect_unit_cap_depth_guard_0	Unit capacity: %+n\\nDepth Guard	true
effects_description_nag_effect_unit_cap_terrorgheist	Unit capacity: %+n\\nDeath Shriek Terrorgheist	true
effects_description_nag_effect_unit_cap_carronade	Unit capacity: %+n\\nCarronades	true
effects_description_nag_effect_unit_cap_necrofex_colossus_0	Unit capacity: %+n\\nNecrofex Colossus	true
effects_description_nag_effect_unit_cap_nag_undead_chariot_unit	Unit capacity: %+n\\nUndead Chariots	true
effects_description_nag_effect_vigpro_nagash_skeleton_giant	Unit capacity: %+n\\nSkeleton Giant	true
effects_description_nag_effect_vigpro_nagash_skeleton_goblin_melee	Unit capacity: %+n\\nSkeleton Goblins	true
effects_description_nag_effect_vigpro_nagash_skeleton_goblin_range	Unit capacity: %+n\\nSkeleton Goblin Archers	true
effects_description_nag_effect_vigpro_nagash_skeleton_orcs	Unit capacity: %+n\\nSkeleton Orcs	true
effects_description_nag_effect_vigpro_nagash_skeleton_troll_1h	Unit capacity: %+n\\nSkeleton Trolls	true
effects_description_nag_effect_vigpro_nagash_skeleton_troll_2h	Unit capacity: %+n\\nSkeleton Trolls (Great Weapons)	true
