key	text	tooltip
#Loc;1;text/db/nag_ancillaries.loc		
ancillaries_onscreen_name_nag_anc_mount_mannfred_barded_nightmare	Barded Nightmare	true
ancillaries_colour_text_nag_anc_mount_mannfred_barded_nightmare	The steeds of the Midnight Aristocracy are unnatural destriers called Nightmares. They are Undead stallions clad in baroque barding.	true
ancillaries_onscreen_name_nag_anc_mount_neferata_warhorse	Barded Nightmare	true
ancillaries_colour_text_nag_anc_mount_neferata_warhorse	The steeds of the Midnight Aristocracy are unnatural destriers called Nightmares. They are Undead stallions clad in baroque barding.	true
ancillaries_onscreen_name_nag_anc_mount_luthor_harkon_terrorgheist	Death Shriek Terrorgheist	true
ancillaries_colour_text_nag_anc_mount_luthor_harkon_terrorgheist	Harkon's personal mount is a dreadful thing indeed - a Terrorgheist with a piercing, banshee-like shriek that has the power to stun any who hear it.	true
ancillaries_onscreen_name_nag_anc_mount_arkhan_skeletal_steed	Skeletal Steed	true
ancillaries_colour_text_nag_anc_mount_arkhan_skeletal_steed	Long-dead destriers, awakened to serve their Unliving masters far beyond death.	true
ancillaries_onscreen_name_nag_anc_mount_arkhan_skeleton_chariot	Skeleton Chariot	true
ancillaries_colour_text_nag_anc_mount_arkhan_skeleton_chariot	The pride of Nehekharan armies, impacting enemy lines with bone-shattering force and grinding the corpses beneath their heavy wheels.	true
ancillaries_onscreen_name_nag_anc_mount_mannfred_abyssal	Ashigaroth, Gorger Upon the Meek	true
ancillaries_colour_text_nag_anc_mount_mannfred_abyssal	The dread abyssal ridden by Mannfred von Carstein was known to myth as Ashigaroth. Now reborn as a creature of chill bone in the mortal world, Ashigaroth hunts the living as readily as it ever did the dead, galloping through the skies to follow the spirit-spoor of prey.	true
ancillaries_onscreen_name_nag_anc_mount_arkhan_abyssal	Razarak, the Doom of Traitors	true
ancillaries_colour_text_nag_anc_mount_arkhan_abyssal	The dread abyssal ridden by Arkhan the Black was known to myth as Razarak. Whilst other dread abyssals scoured the depths of the Underworld, Razarak always sought lofty perches from which to track its prey. Such behavior was well-suited to its duties, for treachery is best judged from on high.	true
ancillaries_onscreen_name_nag_anc_mount_neferata_abyssal	Nagadron, the Adevore	true
ancillaries_colour_text_nag_anc_mount_neferata_abyssal	The dread abyssal ridden by Neferata was known to myth as Nagadron. So voracious is Nagadron that it needs little goading to feast upon other prey, and gorges itself upon the living as eagerly as it did the souls of the dead.	true
ancillaries_onscreen_name_nag_anc_armour_morikhane_the_black_armour	Morikhane, the Black Armour	true
ancillaries_colour_text_nag_anc_armour_morikhane_the_black_armour	 Nagash's armour is forged from an alloy of lead and meteoric iron. Over the millennia the armour has fused itself with his body, so it may only be worn by Nagash. Obviously, the armour does not prevent him casting spells.	true
ancillaries_onscreen_name_nag_anc_weapon_the_mortis_blade	Zefet-netbar, the Mortis Blade	true
ancillaries_colour_text_nag_anc_weapon_the_mortis_blade	Mortis is a huge magic sword that crackles with unearthly power. The blade was forged and enchanted by Nagash himself and no-one else may use it. The sword increases his already considerable strength, and wounds caused by the sword can be used to heal Nagash himself.	true
ancillaries_onscreen_name_nag_anc_arcane_item_alakanash_staff_of_power	Alakanash, the Staff of Power	true
ancillaries_colour_text_nag_anc_arcane_item_alakanash_staff_of_power	The Staff of Power was created by Nagash to allow him to store the additional power he needed to carry out his most arcane and dangerous magical spells.	true
ancillaries_onscreen_name_nag_anc_enchanted_item_crown_of_nagash	The Crown of Nagash	true
ancillaries_colour_text_nag_anc_enchanted_item_crown_of_nagash	The Crown of Nagash sometimes known as the Crown of Sorcery is a magical crown/circlet forged by the great Necromancer Nagash around -1300 IC in his fortress of Nagashizzar in Cripple Peak. The crown is infused with part of Nagash's malicious spirit, partially holding his spirit to the mortal world, and exerts a corrupting influence on anyone who wears it.	true
ancillaries_onscreen_name_nag_anc_enchanted_item_crown_of_nagash_customs_only	The Crown of Nagash	true
ancillaries_colour_text_nag_anc_enchanted_item_crown_of_nagash_customs_only	The Crown of Nagash sometimes known as the Crown of Sorcery is a magical crown/circlet forged by the great Necromancer Nagash around -1300 IC in his fortress of Nagashizzar in Cripple Peak. The crown is infused with part of Nagash's malicious spirit, partially holding his spirit to the mortal world, and exerts a corrupting influence on anyone who wears it.	true
ancillaries_onscreen_name_nag_anc_talisman_books_of_nagash_book_one	First Book of Nagash	true
ancillaries_colour_text_nag_anc_talisman_books_of_nagash_book_one	The first book of Nagash's greatest spell tomes known as the Nine Books of Nagash.	true
ancillaries_onscreen_name_nag_anc_talisman_books_of_nagash_book_two	Second Book of Nagash	true
ancillaries_colour_text_nag_anc_talisman_books_of_nagash_book_two	The second book of Nagash's greatest spell tomes known as the Nine Books of Nagash.	true
ancillaries_onscreen_name_nag_anc_talisman_books_of_nagash_book_three	Third Book of Nagash	true
ancillaries_colour_text_nag_anc_talisman_books_of_nagash_book_three	The third book of Nagash's greatest spell tomes known as the Nine Books of Nagash.	true
ancillaries_onscreen_name_nag_anc_talisman_books_of_nagash_book_four	Fourth Book of Nagash	true
ancillaries_colour_text_nag_anc_talisman_books_of_nagash_book_four	The fourth book of Nagash's greatest spell tomes known as the Nine Books of Nagash.	true
ancillaries_onscreen_name_nag_anc_talisman_books_of_nagash_book_five	Fifth Book of Nagash	true
ancillaries_colour_text_nag_anc_talisman_books_of_nagash_book_five	The fifth book of Nagash's greatest spell tomes known as the Nine Books of Nagash.	true
ancillaries_onscreen_name_nag_anc_talisman_books_of_nagash_book_six	Sixth Book of Nagash	true
ancillaries_colour_text_nag_anc_talisman_books_of_nagash_book_six	The sixth book of Nagash's greatest spell tomes known as the Nine Books of Nagash.	true
ancillaries_onscreen_name_nag_anc_talisman_books_of_nagash_book_seven	Seventh Book of Nagash	true
ancillaries_colour_text_nag_anc_talisman_books_of_nagash_book_seven	The seventh book of Nagash's greatest spell tomes known as the Nine Books of Nagash.	true
ancillaries_onscreen_name_nag_anc_talisman_books_of_nagash_book_eight	Eighth Book of Nagash	true
ancillaries_colour_text_nag_anc_talisman_books_of_nagash_book_eight	The eighth book of Nagash's greatest spell tomes known as the Nine Books of Nagash.	true
ancillaries_onscreen_name_nag_anc_talisman_books_of_nagash_book_nine	Ninth Book of Nagash	true
ancillaries_colour_text_nag_anc_talisman_books_of_nagash_book_nine	The ninth and final book of Nagash's greatest spell tomes known as the Nine Books of Nagash.	true
ancillaries_onscreen_name_nag_anc_husk_talisman_books_of_nagash_book_two	Second Book of Nagash	false
ancillaries_colour_text_nag_anc_husk_talisman_books_of_nagash_book_two	The second book of Nagash's greatest spell tomes known as the Nine Books of Nagash.	false
ancillaries_onscreen_name_nag_anc_husk_talisman_books_of_nagash_book_three	Third Book of Nagash	false
ancillaries_colour_text_nag_anc_husk_talisman_books_of_nagash_book_three	The third book of Nagash's greatest spell tomes known as the Nine Books of Nagash.	false
ancillaries_onscreen_name_nag_anc_husk_talisman_books_of_nagash_book_eight	Eighth Book of Nagash	false
ancillaries_colour_text_nag_anc_husk_talisman_books_of_nagash_book_eight	The eighth book of Nagash's greatest spell tomes known as the Nine Books of Nagash.	false
ancillaries_onscreen_name_nag_anc_armour_armour_of_templehof	Armour of Templehof	true
ancillaries_colour_text_nag_anc_armour_armour_of_templehof	A product of twisted sorcery, this construct fuses with the wearer, giving him tremendous endurance.	true
ancillaries_onscreen_name_nag_anc_weapon_sword_of_unholy_power	Gheistvor, Sword of Unholy Power	true
ancillaries_colour_text_nag_anc_weapon_sword_of_unholy_power	Whenever this blade tastes blood, its wielder seems to exert greater control over the Winds of Magic.	true
ancillaries_onscreen_name_nag_anc_weapon_the_tomb_blade_of_arkhan	Zefet-kar, the Tomb Blade	true
ancillaries_colour_text_nag_anc_weapon_the_tomb_blade_of_arkhan	The sword burns away the flesh of Arkhan's victims, leaving nothing but a charred skeleton, bound to the Liche King's dark will for all eternity.	true
ancillaries_onscreen_name_nag_anc_arcane_item_staff_of_nagash	Khenash-an, Staff of Spirits	true
ancillaries_colour_text_nag_anc_arcane_item_staff_of_nagash	Created by the Arch-Necromancer, the staff harnesses Dark Magic from deep within the accursed Black Pyramid.	true
ancillaries_onscreen_name_nag_anc_enchanted_item_slann_gold	Slann Gold	true
ancillaries_colour_text_nag_anc_enchanted_item_slann_gold	It is well known that Lustrian gold is enchanted with all manner of esoteric properties; Harkon thinks it will restore his fractured mind! 	true
ancillaries_onscreen_name_nag_anc_weapon_dagger_of_jet	Akmet-kar, the Dagger of Jet	true
ancillaries_colour_text_nag_anc_weapon_dagger_of_jet	The blades cursed edge screams with the death agonies of innocents and saps the vitality and fighting spirit of its victims.	true
ancillaries_onscreen_name_nag_anc_arcane_item_staff_of_pain	Aken-seth, the Staff of Pain	true
ancillaries_colour_text_nag_anc_arcane_item_staff_of_pain	It's wicked enchantments add crippling agonies to any sorceries she wields.	true
ancillaries_onscreen_name_nag_anc_arcane_item_staff_of_pain_custom_only	Aken-seth, the Staff of Pain	true
ancillaries_colour_text_nag_anc_arcane_item_staff_of_pain_custom_only	It's wicked enchantments add crippling agonies to any sorceries she wields.	true
ancillaries_onscreen_name_nag_anc_talisman_the_carstein_ring	The Carstein Ring	true
ancillaries_colour_text_nag_anc_talisman_the_carstein_ring	An ancestral ring, set with a gem of deep, sanguine claret that has granted the von Carsteins everlasting Undeath.	true
ancillaries_onscreen_name_nag_anc_weapon_blood_drinker	Blood Drinker	true
ancillaries_colour_text_nag_anc_weapon_blood_drinker	This accursed blade drinks deep of its victim's blood, restoring vigour and strength to the one who brandishes it.	true
ancillaries_onscreen_name_nag_anc_enchanted_item_blood_chalice_of_bathori	Blood Chalice of Bathori	true
ancillaries_colour_text_nag_anc_enchanted_item_blood_chalice_of_bathori	The life essence of many wretched, innocent smallfolk ensures that those who drink from this cursed cup thrive with newfound power.	true
ancillaries_onscreen_name_nag_anc_mount_isabella_hellsteed	Hellsteed	true
ancillaries_colour_text_nag_anc_mount_isabella_hellsteed	Hellsteeds are the unholy fusion of horse and giant bat, bound by Dark Magic - a fitting steed for a Vampire noble.	true
ancillaries_onscreen_name_nag_anc_mount_isabella_barded_nightmare	Barded Nightmare	true
ancillaries_colour_text_nag_anc_mount_isabella_barded_nightmare	The steeds of the Midnight Aristocracy are unnatural destriers called Nightmares - Undead stallions clad in baroque barding.	true
ancillaries_onscreen_name_nag_anc_weapon_chaos_tomb_blade	Chaos Tomb Blade	true
ancillaries_colour_text_nag_anc_weapon_chaos_tomb_blade	This cursed blade fills its wielder with an unholy energy, but also entraps the souls of those it cleaves including its former master, binding their jleshless remains in servitude.	true
ancillaries_onscreen_name_nag_anc_armour_armour_of_the_barrows	Armour of the Barrows	true
ancillaries_colour_text_nag_anc_armour_armour_of_the_barrows	The passage of the ages has strengthened rather than weakened this elaborate Chaos plate armour. Such is the aura of entropy that surrounds it that it has the power to decay the magic of enemy weapons in an instant.	true
ancillaries_onscreen_name_nag_anc_weapon_black_axe_of_krell	The Black Axe of Krell	true
ancillaries_colour_text_nag_anc_weapon_black_axe_of_krell	When the Black Axe of Krell bites into flesh, it leaves behind jagged shards that swiftly eat their way into the victim's heart.	true
ancillaries_onscreen_name_nag_anc_mount_tomb_king_skeletal_steed	Skeletal Steed	true
ancillaries_colour_text_nag_anc_mount_tomb_king_skeletal_steed	Long-dead destriers, awakened to serve their Unliving masters far beyond death.	true
ancillaries_onscreen_name_nag_anc_mount_tomb_king_skeleton_chariot	Skeleton Chariot	true
ancillaries_colour_text_nag_anc_mount_tomb_king_skeleton_chariot	The pride of Nehekharan armies, impacting enemy lines with bone-shattering force and grinding the corpses beneath their heavy wheels.	true
ancillaries_onscreen_name_nag_anc_mount_tomb_king_khemrian_warsphinx	Khemrian Warsphinx	true
ancillaries_onscreen_name_nag_anc_mount_tomb_prince_skeletal_steed	Skeletal Steed	true
ancillaries_colour_text_nag_anc_mount_tomb_prince_skeletal_steed	Long-dead destriers, awakened to serve their Unliving masters far beyond death.	true
ancillaries_onscreen_name_nag_anc_mount_tomb_prince_skeleton_chariot	Skeleton Chariot	true
ancillaries_colour_text_nag_anc_mount_tomb_prince_skeleton_chariot	The pride of Nehekharan armies, impacting enemy lines with bone-shattering force and grinding the corpses beneath their heavy wheels.	true
ancillaries_colour_text_nag_anc_mount_tomb_king_khemrian_warsphinx	Giant leonine statues, almost impervious to harm; they wade through foes, crushing them like bothersome insects.	true
ancillaries_onscreen_name_nag_anc_mount_liche_priest_death_skeletal_steed	Skeletal Steed	true
ancillaries_colour_text_nag_anc_mount_liche_priest_death_skeletal_steed	Long-dead destriers, awakened to serve their Unliving masters far beyond death.	true
ancillaries_onscreen_name_nag_anc_mount_liche_priest_light_skeletal_steed	Skeletal Steed	true
ancillaries_colour_text_nag_anc_mount_liche_priest_light_skeletal_steed	Long-dead destriers, awakened to serve their Unliving masters far beyond death.	true
ancillaries_onscreen_name_nag_anc_mount_liche_priest_nehekhara_skeletal_steed	Skeletal Steed	true
ancillaries_colour_text_nag_anc_mount_liche_priest_nehekhara_skeletal_steed	Long-dead destriers, awakened to serve their Unliving masters far beyond death.	true
ancillaries_onscreen_name_nag_anc_mount_liche_priest_shadow_skeletal_steed	Skeletal Steed	true
ancillaries_colour_text_nag_anc_mount_liche_priest_shadow_skeletal_steed	Long-dead destriers, awakened to serve their Unliving masters far beyond death.	true
ancillaries_onscreen_name_nag_anc_mount_liche_priest_undeath_skeletal_steed	Skeletal Steed	true
ancillaries_colour_text_nag_anc_mount_liche_priest_undeath_skeletal_steed	Long-dead destriers, awakened to serve their Unliving masters far beyond death.	true
ancillaries_onscreen_name_nag_anc_mount_vmp_vampire_shadow_barded_nightmare	Barded Nightmare	true
ancillaries_colour_text_nag_anc_mount_vmp_vampire_shadow_barded_nightmare	The steeds of the Midnight Aristocracy are unnatural destriers called Nightmares. They are Undead stallions clad in baroque barding.	true
ancillaries_onscreen_name_nag_anc_mount_vmp_vampire_shadow_hellsteed	Hellsteed	true
ancillaries_colour_text_nag_anc_mount_vmp_vampire_shadow_hellsteed	Hellsteeds are the unholy fusion of horse and giant bat, bound by Dark Magic - a fitting steed for a Vampire noble.	true
ancillaries_onscreen_name_nag_anc_mount_vmp_vampire_barded_nightmare	Barded Nightmare	true
ancillaries_colour_text_nag_anc_mount_vmp_vampire_barded_nightmare	The steeds of the Midnight Aristocracy are unnatural destriers called Nightmares. They are Undead stallions clad in baroque barding.	true
ancillaries_onscreen_name_nag_anc_mount_vmp_vampire_hellsteed	Hellsteed	true
ancillaries_colour_text_nag_anc_mount_vmp_vampire_hellsteed	Hellsteeds are the unholy fusion of horse and giant bat, bound by Dark Magic - a fitting steed for a Vampire noble.	true
ancillaries_onscreen_name_nag_anc_mount_vmp_wight_king_barded_skeletal_steed	Barded Skeletal Steed	true
ancillaries_colour_text_nag_anc_mount_vmp_wight_king_barded_skeletal_steed	A Wight King was once a Chieftain or a warrior-king of his tribe and so may have been buried with a loyal steed that still wears its rusted barding.	true
ancillaries_onscreen_name_nag_anc_mount_vmp_wight_king_skeletal_steed	Skeletal Steed	true
ancillaries_colour_text_nag_anc_mount_vmp_wight_king_skeletal_steed	The Wight King calls forth a spectral steed of bone to ride upon, should he have favoured it during his once-lived life.	true
ancillaries_onscreen_name_nag_anc_mount_cst_gunnery_wight_rotting_promethean	Rotting Promethean	true
ancillaries_colour_text_nag_anc_mount_cst_gunnery_wight_rotting_promethean	The unnatural speed and brutality of a reanimated Promethean makes it the ideal mount for any Undead, battle-mongering pirate.	true
ancillaries_onscreen_name_nag_anc_mount_vmp_vampire_lord_barded_nightmare	Barded Nightmare	false
ancillaries_colour_text_nag_anc_mount_vmp_vampire_lord_barded_nightmare	The steeds of the Midnight Aristocracy are unnatural destriers called Nightmares. They are Undead stallions clad in baroque barding.	false
ancillaries_onscreen_name_nag_anc_mount_vmp_vampire_lord_hellsteed	Hellsteed	false
ancillaries_colour_text_nag_anc_mount_vmp_vampire_lord_hellsteed	Hellsteeds are the unholy fusion of horse and giant bat, bound by Dark Magic - a fitting steed for a Vampire noble.	false
ancillaries_onscreen_name_nag_anc_mount_vmp_vampire_lord_zombie_dragon	Zombie Dragon	false
ancillaries_colour_text_nag_anc_mount_vmp_vampire_lord_zombie_dragon	Animated by Dark Magic, a zombie dragon is an unholy parody of a once-noble beast now borne aloft by great tattered wings, its body covered with thick, withered hide.	false
ancillaries_onscreen_name_nag_anc_mount_vmp_master_necromancer_corpse_cart	Corpse Cart	false
ancillaries_colour_text_nag_anc_mount_vmp_master_necromancer_corpse_cart	Corpse Carts act like magnets for Dark Magic, drawing their power from the land itself and re-animating the dead around them.	false
ancillaries_onscreen_name_nag_anc_mount_vmp_master_necromancer_corpse_cart_balefire	Corpse Cart (Balefire)	false
ancillaries_colour_text_nag_anc_mount_vmp_master_necromancer_corpse_cart_balefire	Its brazier burning with supernatural flames, the Cart spits Warpstone – and the madness therein – upon enemy Wizards in its path. 	false
ancillaries_onscreen_name_nag_anc_mount_vmp_master_necromancer_corpse_cart_unholy_lodestone	Corpse Cart (Unholy Lodestone)	false
ancillaries_colour_text_nag_anc_mount_vmp_master_necromancer_corpse_cart_unholy_lodestone	Some Corpse Carts have a great bell mounted upon them, its ominous knell drawing the dead back to shambling Unlife. 	false
ancillaries_onscreen_name_nag_anc_mount_vmp_master_necromancer_barded_nightmare	Barded Nightmare	false
ancillaries_colour_text_nag_anc_mount_vmp_master_necromancer_barded_nightmare	A powerful Necromancer may be deemed worthy to ride on once-proud steeds, now risen to become Nightmares clad in dread barding.	false
ancillaries_onscreen_name_nag_anc_mount_vmp_master_necromancer_hellsteed	Hellsteed	false
ancillaries_colour_text_nag_anc_mount_vmp_master_necromancer_hellsteed	Should the Necromancers please their Vampire masters they may well be gifted with Hellsteeds - winged Nightmares.	false
ancillaries_explanation_text_nag_anc_armour_morikhane_the_black_armour		false
ancillaries_explanation_text_nag_anc_weapon_the_mortis_blade		false
ancillaries_explanation_text_nag_anc_arcane_item_alakanash_staff_of_power		false
ancillaries_explanation_text_nag_anc_enchanted_item_crown_of_nagash		false
ancillaries_explanation_text_nag_anc_talisman_books_of_nagash_book_one		false
ancillaries_explanation_text_nag_anc_talisman_books_of_nagash_book_two		false
ancillaries_explanation_text_nag_anc_talisman_books_of_nagash_book_three		false
ancillaries_explanation_text_nag_anc_talisman_books_of_nagash_book_four		false
ancillaries_explanation_text_nag_anc_talisman_books_of_nagash_book_five		false
ancillaries_explanation_text_nag_anc_talisman_books_of_nagash_book_six		false
ancillaries_explanation_text_nag_anc_talisman_books_of_nagash_book_seven		false
ancillaries_explanation_text_nag_anc_talisman_books_of_nagash_book_eight		false
ancillaries_explanation_text_nag_anc_talisman_books_of_nagash_book_nine		false
ancillaries_explanation_text_nag_anc_husk_talisman_books_of_nagash_book_two		false
ancillaries_explanation_text_nag_anc_husk_talisman_books_of_nagash_book_three		false
ancillaries_explanation_text_nag_anc_husk_talisman_books_of_nagash_book_eight		false
ancillaries_explanation_text_nag_anc_mount_mannfred_barded_nightmare		false
ancillaries_explanation_text_nag_anc_mount_mannfred_abyssal		false
ancillaries_explanation_text_nag_anc_armour_armour_of_templehof		false
ancillaries_explanation_text_nag_anc_weapon_sword_of_unholy_power		false
ancillaries_explanation_text_nag_anc_mount_arkhan_skeletal_steed		false
ancillaries_explanation_text_nag_anc_mount_arkhan_skeleton_chariot		false
ancillaries_explanation_text_nag_anc_mount_vmp_vampire_lord_barded_nightmare		false
ancillaries_explanation_text_nag_anc_mount_vmp_vampire_lord_hellsteed		false
ancillaries_explanation_text_nag_anc_mount_vmp_vampire_lord_zombie_dragon		false
ancillaries_explanation_text_nag_anc_mount_vmp_master_necromancer_corpse_cart		false
ancillaries_explanation_text_nag_anc_mount_vmp_master_necromancer_corpse_cart_balefire		false
ancillaries_explanation_text_nag_anc_mount_vmp_master_necromancer_corpse_cart_unholy_lodestone		false
ancillaries_explanation_text_nag_anc_mount_vmp_master_necromancer_barded_nightmare		false
ancillaries_explanation_text_nag_anc_mount_vmp_master_necromancer_hellsteed		false
ancillaries_explanation_text_nag_anc_mount_arkhan_abyssal		false
ancillaries_explanation_text_nag_anc_weapon_the_tomb_blade_of_arkhan		false
ancillaries_explanation_text_nag_anc_arcane_item_staff_of_nagash		false
ancillaries_explanation_text_nag_anc_mount_luthor_harkon_terrorgheist		false
ancillaries_explanation_text_nag_anc_enchanted_item_slann_gold		false
ancillaries_explanation_text_nag_anc_mount_neferata_warhorse		false
ancillaries_explanation_text_nag_anc_mount_neferata_abyssal		false
ancillaries_explanation_text_nag_anc_weapon_dagger_of_jet		false
ancillaries_explanation_text_nag_anc_arcane_item_staff_of_pain		false
ancillaries_explanation_text_nag_anc_arcane_item_staff_of_pain_custom_only		false
ancillaries_explanation_text_nag_anc_talisman_the_carstein_ring		false
ancillaries_explanation_text_nag_anc_weapon_blood_drinker		false
ancillaries_explanation_text_nag_anc_enchanted_item_blood_chalice_of_bathori		false
ancillaries_explanation_text_nag_anc_mount_isabella_barded_nightmare		false
ancillaries_explanation_text_nag_anc_mount_isabella_hellsteed		false
ancillaries_explanation_text_nag_anc_weapon_chaos_tomb_blade		false
ancillaries_explanation_text_nag_anc_armour_armour_of_the_barrows		false
ancillaries_explanation_text_nag_anc_weapon_black_axe_of_krell		false
ancillaries_explanation_text_nag_anc_mount_tomb_king_skeletal_steed		false
ancillaries_explanation_text_nag_anc_mount_tomb_king_skeleton_chariot		false
ancillaries_explanation_text_nag_anc_mount_tomb_king_khemrian_warsphinx		false
ancillaries_explanation_text_nag_anc_mount_tomb_prince_skeletal_steed		false
ancillaries_explanation_text_nag_anc_mount_tomb_prince_skeleton_chariot		false
ancillaries_explanation_text_nag_anc_mount_liche_priest_death_skeletal_steed		false
ancillaries_explanation_text_nag_anc_mount_liche_priest_light_skeletal_steed		false
ancillaries_explanation_text_nag_anc_mount_liche_priest_nehekhara_skeletal_steed		false
ancillaries_explanation_text_nag_anc_mount_liche_priest_shadow_skeletal_steed		false
ancillaries_explanation_text_nag_anc_mount_liche_priest_undeath_skeletal_steed		false
ancillaries_explanation_text_nag_anc_mount_vmp_vampire_shadow_barded_nightmare		false
ancillaries_explanation_text_nag_anc_mount_vmp_vampire_shadow_hellsteed		false
ancillaries_explanation_text_nag_anc_mount_vmp_vampire_barded_nightmare		false
ancillaries_explanation_text_nag_anc_mount_vmp_vampire_hellsteed		false
ancillaries_explanation_text_nag_anc_mount_vmp_wight_king_barded_skeletal_steed		false
ancillaries_explanation_text_nag_anc_mount_vmp_wight_king_skeletal_steed		false
ancillaries_explanation_text_nag_anc_mount_cst_gunnery_wight_rotting_promethean		false
ancillaries_onscreen_name_nag_anc_armour_azhags_ard_armour	Azhag's 'Ard Armour	false
ancillaries_colour_text_nag_anc_armour_azhags_ard_armour	No ordinary armour would suit a Warboss such as Azhag, it had to be ‘ard - really, really ‘ard.	false
ancillaries_explanation_text_nag_anc_armour_azhags_ard_armour		false
ancillaries_onscreen_name_nag_anc_enchanted_item_the_crown_of_sorcery	The Crown of Sorcery	false
ancillaries_colour_text_nag_anc_enchanted_item_the_crown_of_sorcery	The Crown of Sorcery was found in the ruins of Todtheim by Azhag the Slaughterer. Its malign influence has helped the Warboss carve a path of destruction throughout the Empire, for the Crown whispers advice and grants the wearer the power of Death Magic.	false
ancillaries_explanation_text_nag_anc_enchanted_item_the_crown_of_sorcery		false
ancillaries_onscreen_name_nag_anc_weapon_slaggas_slashas	Slagga's Slashas	false
ancillaries_colour_text_nag_anc_weapon_slaggas_slashas	The crude twin blades wielded by Azhag the Slaughterer are known as Slagga’s Slashas, but just who is Slagga?	false
ancillaries_explanation_text_nag_anc_weapon_slaggas_slashas		false
ancillaries_onscreen_name_nag_elo_hand_punished_one	The Punished One	false
ancillaries_colour_text_nag_elo_hand_punished_one	An enemy so hated by the Hand that he was strapped on a halberd and is used as a battlestandard even after death. Those who came close enough and survived swear that the skeleton still screams in agony. Without a sound, yet unbearably loud.	false
ancillaries_explanation_text_nag_elo_hand_punished_one		false
ancillaries_onscreen_name_nag_elo_hungering_blade	The Hungering Blade	false
ancillaries_colour_text_nag_elo_hungering_blade	A gift from Nagash himself. When its wielder fades, the blade awakens and feeds him with the life force of its victims so he may persist against all odds.	false
ancillaries_explanation_text_nag_elo_hungering_blade		false
ancillaries_onscreen_name_nag_Soulreaper	Soulreaper	false
ancillaries_colour_text_nag_Soulreaper	Claiming the souls of the living, trapped inside the sword. once filled allows the summoning of great warriors	false
ancillaries_explanation_text_nag_Soulreaper		false
ancillaries_onscreen_name_wh2_dlc09_anc_arcane_item_enkhils_kanopi	Enkhil's Kanopi	false
ancillaries_colour_text_wh2_dlc09_anc_arcane_item_enkhils_kanopi	The simple clay vessel may not look like much, but the High Priest's Undying essence within can thwart sorcery and strengthen incantations.	false
ancillaries_explanation_text_wh2_dlc09_anc_arcane_item_enkhils_kanopi		false
ancillaries_onscreen_name_nag_anc_arcane_item_neferras_scrolls_of_mighty_incantations	Neferra's Scrolls of Mighty Incantations	false
ancillaries_colour_text_nag_anc_arcane_item_neferras_scrolls_of_mighty_incantations	These eight magical scrolls, containing the sum total of Neferra's lifetime of learning, can whip up an unstoppable hurricane of power to crush the foe.	false
ancillaries_explanation_text_nag_anc_arcane_item_neferras_scrolls_of_mighty_incantations		false
ancillaries_onscreen_name_nag_anc_armour_armour_of_eternity	Armour of Eternity	false
ancillaries_colour_text_nag_anc_armour_armour_of_eternity	Forged from bronze, cooled in the blood of the giant Lybrasian scorpion, and gilded in red and Lahmian gold, this ancient breastplate will turn aside all but the strongest of blows.	false
ancillaries_explanation_text_nag_anc_armour_armour_of_eternity		false
ancillaries_onscreen_name_nag_anc_armour_scorpion_armour	Scorpion Armour	false
ancillaries_colour_text_nag_anc_armour_scorpion_armour	These ornate armour plates are decorated with the likeness of the Scorpion-God; his protective energies pervade the very metal used, offering additional protection to the wearer.	false
ancillaries_explanation_text_nag_anc_armour_scorpion_armour		false
ancillaries_onscreen_name_nag_anc_enchanted_item_brooch_of_the_great_desert	Brooch of the Great Desert	false
ancillaries_colour_text_nag_anc_enchanted_item_brooch_of_the_great_desert	The elaborate piece of jewellery hampers the effectiveness of Dark Magic ranged against it.	false
ancillaries_explanation_text_nag_anc_enchanted_item_brooch_of_the_great_desert		false
ancillaries_onscreen_name_nag_anc_enchanted_item_cloak_of_the_dunes	Cloak of the Dunes	false
ancillaries_colour_text_nag_anc_enchanted_item_cloak_of_the_dunes	The desert itself shall be your coat... and the foe's undoing.	false
ancillaries_explanation_text_nag_anc_enchanted_item_cloak_of_the_dunes		false
ancillaries_onscreen_name_nag_anc_enchanted_item_elixir_of_might	Elixir of Might	false
ancillaries_colour_text_nag_anc_enchanted_item_elixir_of_might	One sip of the elixir fills the body of its drinker with the strength of many powerful, elite warriors.	false
ancillaries_explanation_text_nag_anc_enchanted_item_elixir_of_might		false
ancillaries_onscreen_name_nag_anc_enchanted_item_golden_deathmask_of_kharnut	Golden Death Mask of Kharnut	false
ancillaries_colour_text_nag_anc_enchanted_item_golden_deathmask_of_kharnut	Death's foul taint hangs heavy from Prince Kharnut's elaborate deathmask, gripping the hearts of those who gaze upon it and freezing them in terror.	false
ancillaries_explanation_text_nag_anc_enchanted_item_golden_deathmask_of_kharnut		false
ancillaries_onscreen_name_nag_anc_enchanted_item_hieratic_jar	Hieratic Jar	false
ancillaries_colour_text_nag_anc_enchanted_item_hieratic_jar	Sealed and bound with powerful glyphs, this jar contains the remains of a Liche Priest and all the magical energy at his command.	false
ancillaries_explanation_text_nag_anc_enchanted_item_hieratic_jar		false
ancillaries_onscreen_name_nag_anc_enchanted_item_vambraces_of_the_sun	Vambraces of the Sun	false
ancillaries_colour_text_nag_anc_enchanted_item_vambraces_of_the_sun	Infused with the sun's dazzling intensity, the power harnessed within gleams brilliantly, blinding the wearer's opponents.	false
ancillaries_explanation_text_nag_anc_enchanted_item_vambraces_of_the_sun		false
ancillaries_onscreen_name_nag_anc_magic_standard_banner_of_the_hidden_dead	Banner of the Hidden Dead	false
ancillaries_colour_text_nag_anc_magic_standard_banner_of_the_hidden_dead	This banner is wrought with powerful incantations that draw the ancient dead to it and bind their souls to the remains of long-dead warriors.	false
ancillaries_explanation_text_nag_anc_magic_standard_banner_of_the_hidden_dead		false
ancillaries_onscreen_name_nag_anc_magic_standard_standard_of_the_undying_legion	Standard of the Undying Legion	false
ancillaries_colour_text_nag_anc_magic_standard_standard_of_the_undying_legion	Containing the spirits of King Lahmizzar's Jackal Legion, this banner restores the fallen so they might fulfil their undying pledge.	false
ancillaries_explanation_text_nag_anc_magic_standard_standard_of_the_undying_legion		false
ancillaries_onscreen_name_nag_anc_talisman_amulet_of_pha_stah	Amulet of Pha-Stah	false
ancillaries_colour_text_nag_anc_talisman_amulet_of_pha_stah	This moon-shaped amulet projects a disruptive magical energy onto the enemy's defences.	false
ancillaries_explanation_text_nag_anc_talisman_amulet_of_pha_stah		false
ancillaries_onscreen_name_nag_anc_weapon_blade_of_antarhak	Blade of Antarhak	false
ancillaries_colour_text_nag_anc_weapon_blade_of_antarhak	This Tomb Prince's magical sword draws lifeforce from the slain to imbue the body of its wielder with stolen essence.	false
ancillaries_explanation_text_nag_anc_weapon_blade_of_antarhak		false
ancillaries_onscreen_name_nag_anc_weapon_blade_of_mourning_fire	Blade of Mourning Fire	false
ancillaries_colour_text_nag_anc_weapon_blade_of_mourning_fire	Forged in the heart of Settra's pyramid, only sorrow and despair are left behind when this enchanted blade has done its deadly work.	false
ancillaries_explanation_text_nag_anc_weapon_blade_of_mourning_fire		false
ancillaries_onscreen_name_nag_anc_weapon_blade_of_setep	Blade of Setep	false
ancillaries_colour_text_nag_anc_weapon_blade_of_setep	The very late King Setep's ornamented, curved sword shimmers with a blue hue that shatters the foe's armour.	false
ancillaries_explanation_text_nag_anc_weapon_blade_of_setep		false
ancillaries_onscreen_name_nag_anc_weapon_crook_and_flail_of_radiance	Crook & Flail of Radiance	false
ancillaries_colour_text_nag_anc_weapon_crook_and_flail_of_radiance	All in the presence of these weapons' bearer are strangely humbled by the aura of majesty they convey.	false
ancillaries_explanation_text_nag_anc_weapon_crook_and_flail_of_radiance		false
ancillaries_onscreen_name_nag_anc_weapon_destroyer_of_eternities	Destroyer of Eternities	false
ancillaries_colour_text_nag_anc_weapon_destroyer_of_eternities	This enchanted, impossibly-sharp blade can cleave through armour, flesh, bone and souls with equal ease, reducing victims to a lifeless husk.	false
ancillaries_explanation_text_nag_anc_weapon_destroyer_of_eternities		false
ancillaries_onscreen_name_nag_anc_arcane_item_scroll_of_arnizipals_black_horror	Scroll of Black Horror	false
ancillaries_colour_text_nag_anc_arcane_item_scroll_of_arnizipals_black_horror		false
ancillaries_explanation_text_nag_anc_arcane_item_scroll_of_arnizipals_black_horror		false
ancillaries_onscreen_name_nag_anc_armour_armour_of_the_depth	Armour of the Deep	false
ancillaries_colour_text_nag_anc_armour_armour_of_the_depth	Fashioned from interlocking tentacles and seashells and permanently dripping with slime, this armour clings to the wearer's body, allowing them to move freely.	false
ancillaries_explanation_text_nag_anc_armour_armour_of_the_depth		false
ancillaries_onscreen_name_nag_anc_armour_seadragon_buckler	Sea-Dragon Buckler	false
ancillaries_colour_text_nag_anc_armour_seadragon_buckler	Every pirate's favourite, this buckler is layered with Sea-Dragon scales which provide reliable protection yet weigh virtually nothing.	false
ancillaries_explanation_text_nag_anc_armour_seadragon_buckler		false
ancillaries_onscreen_name_nag_anc_enchanted_item_black_buckthorns_treasure_map	Black Buckthorn's Treasure Map	false
ancillaries_colour_text_nag_anc_enchanted_item_black_buckthorns_treasure_map	A long-lost treasure map, leading to long-lost treasure. Due to its accuracy and level of detail, it can also double as a battle map.	false
ancillaries_explanation_text_nag_anc_enchanted_item_black_buckthorns_treasure_map		false
ancillaries_onscreen_name_nag_anc_enchanted_item_moonshine	Moonshine	false
ancillaries_colour_text_nag_anc_enchanted_item_moonshine	The classic pirate brew. It makes one extremely fiery... in every way!	false
ancillaries_explanation_text_nag_anc_enchanted_item_moonshine		false
ancillaries_onscreen_name_nag_anc_enchanted_item_pyrotechnic_compound	Pyrotechnic Compound	false
ancillaries_colour_text_nag_anc_enchanted_item_pyrotechnic_compound	These incendiary chemicals give ordinary shot that special glow as it flies towards the target, turning them into a screaming, staggering torch on contact.	false
ancillaries_explanation_text_nag_anc_enchanted_item_pyrotechnic_compound		false
ancillaries_onscreen_name_nag_anc_magic_standard_bloodied_banner_of_slayers	Bloodied Banner of Slayers	false
ancillaries_colour_text_nag_anc_magic_standard_bloodied_banner_of_slayers	The former owners of this banner have no further use for it themselves…	false
ancillaries_explanation_text_nag_anc_magic_standard_bloodied_banner_of_slayers		false
ancillaries_onscreen_name_nag_anc_magic_standard_burnt_banner_of_knights	Burnt Banner of Knights	false
ancillaries_colour_text_nag_anc_magic_standard_burnt_banner_of_knights	"Ah, the cavalry's here! Yarrrr!!!"	false
ancillaries_explanation_text_nag_anc_magic_standard_burnt_banner_of_knights		false
ancillaries_onscreen_name_nag_anc_magic_standard_corpse_surgeon	War Standard o' the Corpse Surgeons	false
ancillaries_colour_text_nag_anc_magic_standard_corpse_surgeon	You'd think there'd be no need for surgery on a ship crewed by the dead, but you'd be wrong - someone who can sew limbs back on double-quick is worth their weight in grog!	false
ancillaries_explanation_text_nag_anc_magic_standard_corpse_surgeon		false
ancillaries_onscreen_name_nag_anc_magic_standard_dead_mans_chest	Dead Man's Chest	false
ancillaries_colour_text_nag_anc_magic_standard_dead_mans_chest	The owner of this chest refuses to let go of it even though they're dead.	false
ancillaries_explanation_text_nag_anc_magic_standard_dead_mans_chest		false
ancillaries_onscreen_name_nag_anc_magic_standard_holed_banner_of_militia	Holed Banner of Militia	false
ancillaries_colour_text_nag_anc_magic_standard_holed_banner_of_militia	"Never give the zombies explosives, they'll blow the whole ship apart - you, me, the loot... everything!"	false
ancillaries_explanation_text_nag_anc_magic_standard_holed_banner_of_militia		false
ancillaries_onscreen_name_nag_anc_magic_standard_skull_and_crossbones	Skull & Crossbones	false
ancillaries_colour_text_nag_anc_magic_standard_skull_and_crossbones	In these days of grand alliances and complex treaties, there is something to be said for making your intentions abundantly clear from the outset.	false
ancillaries_explanation_text_nag_anc_magic_standard_skull_and_crossbones		false
ancillaries_onscreen_name_nag_anc_magic_standard_spell_of_the_necromancers_apprentice	Spell of the Necromancer's Apprentice	false
ancillaries_colour_text_nag_anc_magic_standard_spell_of_the_necromancers_apprentice	Practice makes perfect, in Dark Magic as in all things.	false
ancillaries_explanation_text_nag_anc_magic_standard_spell_of_the_necromancers_apprentice		false
ancillaries_onscreen_name_nag_anc_magic_standard_torn_banner_of_pilgrims	Torn Banner of Pilgrims	false
ancillaries_colour_text_nag_anc_magic_standard_torn_banner_of_pilgrims	These lost souls follow only the tides and currents now.	false
ancillaries_explanation_text_nag_anc_magic_standard_torn_banner_of_pilgrims		false
ancillaries_onscreen_name_nag_anc_talisman_blackpearl_eye	Blackpearl False Eye	false
ancillaries_colour_text_nag_anc_talisman_blackpearl_eye	Crafted from the highest-quality blackpearl, legends state that its wearer will be granted the ability to see through the black ocean waters all the way to the sea floor, where untold fortunes are buried.	false
ancillaries_explanation_text_nag_anc_talisman_blackpearl_eye		false
ancillaries_onscreen_name_nag_anc_talisman_jellyfish_in_a_jar	Jellyfish in a Jar	false
ancillaries_colour_text_nag_anc_talisman_jellyfish_in_a_jar	"It won't kill yer - again - but the pain will make you wish it had."	false
ancillaries_explanation_text_nag_anc_talisman_jellyfish_in_a_jar		false
ancillaries_onscreen_name_nag_anc_talisman_kraken_fang	Kraken Tusk	false
ancillaries_colour_text_nag_anc_talisman_kraken_fang	A small dagger made from the tusk of a ferocious sea monster, as cold as the ocean is deep.	false
ancillaries_explanation_text_nag_anc_talisman_kraken_fang		false
ancillaries_onscreen_name_nag_anc_weapon_lucky_levis_hookhand	Lucky Levi's Hookhand	false
ancillaries_colour_text_nag_anc_weapon_lucky_levis_hookhand	From years of sword fighting, or maybe just a moment's rum luck when a pistol backfired, real hands are nevertheless in short supply among pirates.	false
ancillaries_explanation_text_nag_anc_weapon_lucky_levis_hookhand		false
ancillaries_onscreen_name_nag_anc_weapon_masamune	Massa-Moones' Pride	false
ancillaries_colour_text_nag_anc_weapon_masamune	This eastern pirate blade, unmatched in its lethal sharpness, imbues its new owner with a portion of its previous wielder's power and skill.	false
ancillaries_explanation_text_nag_anc_weapon_masamune		false
ancillaries_onscreen_name_nag_anc_arcane_item_black_periapt	Black Periapt	false
ancillaries_colour_text_nag_anc_arcane_item_black_periapt		false
ancillaries_explanation_text_nag_anc_arcane_item_black_periapt		false
ancillaries_onscreen_name_nag_anc_arcane_item_book_of_arkhan	Book of Arkhan	false
ancillaries_colour_text_nag_anc_arcane_item_book_of_arkhan		false
ancillaries_explanation_text_nag_anc_arcane_item_book_of_arkhan		false
ancillaries_onscreen_name_nag_anc_arcane_item_staff_of_damnation	Staff of Damnation	false
ancillaries_colour_text_nag_anc_arcane_item_staff_of_damnation		false
ancillaries_explanation_text_nag_anc_arcane_item_staff_of_damnation		false
ancillaries_onscreen_name_nag_anc_armour_nightshroud	Nightshroud	false
ancillaries_colour_text_nag_anc_armour_nightshroud	Discovered in a vault deep inside Castle Drachenfels, the aura of gloom that clings to the Nightshroud is so strong it physically manifests as armour.	false
ancillaries_explanation_text_nag_anc_armour_nightshroud		false
ancillaries_onscreen_name_nag_anc_enchanted_item_rod_of_flaming_death	Rod of Flaming Death	false
ancillaries_colour_text_nag_anc_enchanted_item_rod_of_flaming_death		false
ancillaries_explanation_text_nag_anc_enchanted_item_rod_of_flaming_death		false
ancillaries_onscreen_name_nag_anc_magic_standard_banner_of_the_barrows	Banner of the Barrows	false
ancillaries_colour_text_nag_anc_magic_standard_banner_of_the_barrows	Woven from the wind and the cold, the chill of this banner touches the hearts of those who stand before it, sapping their will and ability to fight.	false
ancillaries_explanation_text_nag_anc_magic_standard_banner_of_the_barrows		false
ancillaries_onscreen_name_nag_anc_magic_standard_the_screaming_banner	The Screaming Banner	false
ancillaries_colour_text_nag_anc_magic_standard_the_screaming_banner		false
ancillaries_explanation_text_nag_anc_magic_standard_the_screaming_banner		false
ancillaries_onscreen_name_nag_anc_follower_hat_makers_maker	Big Hatter	false
ancillaries_colour_text_nag_anc_follower_hat_makers_maker	These magnificent hats are a visual proclamation of eternal dominion, reminding all who behold them of the indomitable force their wearers have become.	false
ancillaries_explanation_text_nag_anc_follower_hat_makers_maker	Ranked-up above rank 20	false
ancillaries_onscreen_name_nag_anc_follower_death_doctor	Death Doctor	false
ancillaries_colour_text_nag_anc_follower_death_doctor	It wanders amidst the war-torn battlefield, its eyes fixed on those desperately clinging to the fading embers of life. Its purpose, is to liberate them from the torment of existence.	false
ancillaries_explanation_text_nag_anc_follower_death_doctor	Razed a settlement	false
ancillaries_onscreen_name_nag_anc_follower_keeper_of_tomes	Keeper of Tomes	false
ancillaries_colour_text_nag_anc_follower_keeper_of_tomes	Entrusted with the solemn duty of preserving and safeguarding ancient tomes of forbidden knowledge and arcane secrets.	false
ancillaries_explanation_text_nag_anc_follower_keeper_of_tomes	Ranked-up above rank 20	false
ancillaries_onscreen_name_nag_anc_follower_warpstone_hunter	Warpstone Hunter	false
ancillaries_colour_text_nag_anc_follower_warpstone_hunter	Warpstone is Dark Magic incarnate. Undead Lords, especially liches, will employ ghoulish hunters to find such precious ore.	false
ancillaries_explanation_text_nag_anc_follower_warpstone_hunter	Sacked a settlement	false
ancillaries_onscreen_name_nag_anc_follower_warlock	Warlock	false
ancillaries_colour_text_nag_anc_follower_warlock	Warlocks are those that practise the dark arts away from prying eyes. Their novice skill often make them the prey of Witch Hunters and more...	false
ancillaries_explanation_text_nag_anc_follower_warlock		false
ancillaries_onscreen_name_nag_anc_follower_corpse_caravan	Corpse Caravan	false
ancillaries_colour_text_nag_anc_follower_corpse_caravan	"Corpses my master, how many do you need? Yes."	false
ancillaries_explanation_text_nag_anc_follower_corpse_caravan		false
ancillaries_onscreen_name_nag_anc_follower_haunted_hostler	Haunted Hostler	false
ancillaries_colour_text_nag_anc_follower_haunted_hostler	Even the steeds of the damned need a stable-hand to keep them fit and healthy... It's a difficult task trying to saddle a phantom horse though.	false
ancillaries_explanation_text_nag_anc_follower_haunted_hostler	Won a battle with 4 or more cavalry units	false
ancillaries_onscreen_name_nag_anc_follower_carrion	Carrion	false
ancillaries_colour_text_nag_anc_follower_carrion	Carrion are large, Undead, vulture-like creatures that are drawn to battlefields and Unholy summonings.	false
ancillaries_explanation_text_nag_anc_follower_carrion	Ranked-up in a province with low corruption	false
ancillaries_onscreen_name_nag_anc_follower_death_cultist	Cultist of Nagash	false
ancillaries_colour_text_nag_anc_follower_death_cultist	"Great Necromancer, I beseech you, my master, to look upon me with favor and grant me the power to serve you."	false
ancillaries_explanation_text_nag_anc_follower_death_cultist		false
ancillaries_onscreen_name_nag_anc_follower_ghoul_scavanger	Ghoul	false
ancillaries_colour_text_nag_anc_follower_ghoul_scavanger	Ghouls, wretched little creatures, nothing more than prowlers of the dead.	false
ancillaries_explanation_text_nag_anc_follower_ghoul_scavanger	Idle in a region with a Fields building	false
ancillaries_onscreen_name_nag_anc_follower_siren	Siren	false
ancillaries_colour_text_nag_anc_follower_siren	The ethereal voice of the siren calms the dead souls, allowing the Necromancer to bind them more easily.	false
ancillaries_explanation_text_nag_anc_follower_siren		false
ancillaries_onscreen_name_nag_anc_follower_poltergeist	Restless Spirit	false
ancillaries_colour_text_nag_anc_follower_poltergeist	Those spirits who are no longer bound to the mortal plane, can be tethered to his service - for poltergeists have their uses...	false
ancillaries_explanation_text_nag_anc_follower_poltergeist		false
ancillaries_onscreen_name_nag_anc_follower_necromancers_apprentice	Necromancer's Apprentice	false
ancillaries_colour_text_nag_anc_follower_necromancers_apprentice	All this one needs is a dark damp cell, a morbid curiosity and plenty of samples to work with.	false
ancillaries_explanation_text_nag_anc_follower_necromancers_apprentice		false
ancillaries_onscreen_name_nag_anc_follower_lich	Lich	false
ancillaries_colour_text_nag_anc_follower_lich	Spells of decay, curses of suffering, and necrotic incantations flow effortlessly from its bone-chilling voice, resonating with an unholy resonance that can freeze even the bravest of hearts.	false
ancillaries_explanation_text_nag_anc_follower_lich	Ranked-up in a province with high corruption	false
ancillaries_onscreen_name_nag_anc_follower_handmaiden	Handmaiden	false
ancillaries_colour_text_nag_anc_follower_handmaiden	Beware the allure of beauty that dazzles the eye, for it can mask a treacherous heart. Gilded masks and refined manners hide the true nature of those who walk these unhallowed halls.	false
ancillaries_explanation_text_nag_anc_follower_handmaiden	Carried out a successful [[img:icon_hero]][[/img]]Hero action against a character	false
ancillaries_onscreen_name_nag_anc_follower_embalmer	Mummy Embalmer	false
ancillaries_colour_text_nag_anc_follower_embalmer	Skilled hands, weathered by time, expertly wield embalming tools, delicately preparing the deceased for their eternal journey.	false
ancillaries_explanation_text_nag_anc_follower_embalmer		false
ancillaries_onscreen_name_nag_anc_follower_blood_bag	Blood Bag	false
ancillaries_colour_text_nag_anc_follower_blood_bag	A blood bag to sustain the insatiable hunger of an immortal creature, that feeds upon the essence of life itself.	false
ancillaries_explanation_text_nag_anc_follower_blood_bag	Won a battle against a human army	false
ancillaries_onscreen_name_nag_anc_follower_powder_monkey	Powder Monkey	false
ancillaries_colour_text_nag_anc_follower_powder_monkey	It's an extremely dirty and dangerous job, but someone has to do it. After all, even the highest-rated admiral had to start somewhere.	false
ancillaries_explanation_text_nag_anc_follower_powder_monkey		false
ancillaries_onscreen_name_nag_anc_follower_captain_deceased	O Captain!	false
ancillaries_colour_text_nag_anc_follower_captain_deceased	O heart! heart! heart! O the bleeding drops of red, where on the deck my Captain stands, cold and undead.	false
ancillaries_explanation_text_nag_anc_follower_captain_deceased	Ranked-up on sea	false
ancillaries_onscreen_name_nag_anc_follower_cursed_necrotect	Cursed Necrotect	false
ancillaries_colour_text_nag_anc_follower_cursed_necrotect	These ancient architects have designed the most opulent, elaborate crypts and vaults. Too skilled to be allowed to rest.	false
ancillaries_explanation_text_nag_anc_follower_cursed_necrotect		false
ancillaries_onscreen_name_nag_anc_follower_ushabti_bodyguard	Ushabti Bodyguard	false
ancillaries_colour_text_nag_anc_follower_ushabti_bodyguard	An imposing monument to Nehekhara's former power, now living once again in service of its new Master.	false
ancillaries_explanation_text_nag_anc_follower_ushabti_bodyguard	Win a battle against a Tomb King army	false
ancillaries_onscreen_name_nag_anc_follower_the_ravenous_dead	The Ravenous Dead	false
ancillaries_colour_text_nag_anc_follower_the_ravenous_dead	As the Undead rip apart their victims they feast on the organs that spill forth – regaining strength in the process.	false
ancillaries_explanation_text_nag_anc_follower_the_ravenous_dead		false
ancillaries_onscreen_name_nag_anc_follower_undead_bard	Undead Bard	false
ancillaries_colour_text_nag_anc_follower_undead_bard	Dance, dance and hear the sweet sound of death, loss, and the macabre, mourn as we delve into the depths of despair.	false
ancillaries_explanation_text_nag_anc_follower_undead_bard	Ranked-up after winning 6 or more offensive battles	false
ancillaries_onscreen_name_nag_anc_follower_black_cat	Black Cat	false
ancillaries_colour_text_nag_anc_follower_black_cat	Cross their path and test fate as misfortune befalls you, these black cats are said to be the familiars of warlocks and witches, or perhaps they are just cats afterall.	false
ancillaries_explanation_text_nag_anc_follower_black_cat		false
ancillaries_onscreen_name_nag_anc_follower_fan	Immortal Fan	false
ancillaries_colour_text_nag_anc_follower_fan	"You're the best! Can I... Can I follow you around? I won't get in the way! Can I carry your weapon? Shine your boots? Backrub, perhaps?"	false
ancillaries_explanation_text_nag_anc_follower_fan	Won 20 or more battles	false
ancillaries_onscreen_name_nag_anc_arcane_item_enkhils_kanopi	PLACEHOLDER	false
ancillaries_colour_text_nag_anc_arcane_item_enkhils_kanopi	PLACEHOLDER	false
ancillaries_explanation_text_nag_anc_arcane_item_enkhils_kanopi	PLACEHOLDER	false
ancillaries_onscreen_name_nag_anc_talisman_golden_ankhra	PLACEHOLDER	false
ancillaries_colour_text_nag_anc_talisman_golden_ankhra	PLACEHOLDER	false
ancillaries_explanation_text_nag_anc_talisman_golden_ankhra	PLACEHOLDER	false
ancillaries_onscreen_name_nag_anc_talisman_golden_eye_of_rah_nutt	PLACEHOLDER	false
ancillaries_colour_text_nag_anc_talisman_golden_eye_of_rah_nutt	PLACEHOLDER	false
ancillaries_explanation_text_nag_anc_talisman_golden_eye_of_rah_nutt	PLACEHOLDER	false
ancillaries_onscreen_name_nag_anc_weapon_skabscrath	PLACEHOLDER	false
ancillaries_colour_text_nag_anc_weapon_skabscrath	PLACEHOLDER	false
ancillaries_explanation_text_nag_anc_weapon_skabscrath	PLACEHOLDER	false
ancillaries_onscreen_name_nag_anc_mount_grn_azhag_skullmuncha	Skullmuncha	false
ancillaries_colour_text_nag_anc_mount_grn_azhag_skullmuncha	Azhag’s pet wyvern is called Skullmuncha - a gift from the Night Goblins of Red Eye Mountain. The wyvern was fierce, but Azhag immediately calmed the beast with one of his “best glares”; the two have been inseparable ever since.	false
ancillaries_explanation_text_nag_anc_mount_grn_azhag_skullmuncha		false
ancillaries_colour_text_nag_anc_mount_neferata_hellsteed	Hellsteeds are the unholy fusion of horse and giant bat, bound by Dark Magic - a fitting steed for a Vampire noble.	false
ancillaries_explanation_text_nag_anc_mount_neferata_hellsteed		false
ancillaries_onscreen_name_nag_anc_mount_neferata_hellsteed	Hellsteed	false
ancillaries_colour_text_nag_dread_black_jewel	The Black Jewel of the Dread King contains his very soul. Embedded in his rib cage, it beats like an obscene, black and glistening heart.	false
ancillaries_onscreen_name_nag_dread_black_jewel	Heart of Blackness	false
