key	text	tooltip
#Loc;1;text/db/nag_character_skills.loc		
character_skills_localised_name_nag_skill_army_buff_ranged	Arrows of Nagashizzar	true
character_skills_localised_description_nag_skill_army_buff_ranged	Asaph may have turned her back on these arrows, but Nagash's hatred is far-reaching.	true
character_skills_localised_name_nag_skill_army_buff_infantry	Dhar-Scorched Bones	true
character_skills_localised_description_nag_skill_army_buff_infantry	It can't possibly be worse than this.	true
character_skills_localised_name_nag_skill_army_buff_cav	Wicked Cavalrymen	true
character_skills_localised_description_nag_skill_army_buff_cav	Once proud charioteers 'live' to pursue and punish more fortunate souls.	true
character_skills_localised_name_nag_skill_army_buff_beasts	Twisted Malevolence	true
character_skills_localised_description_nag_skill_army_buff_beasts	Deadly claws, deadly poisons, or both. 	true
character_skills_localised_name_nag_skill_army_buff_spirit	Ancient Terrors	true
character_skills_localised_description_nag_skill_army_buff_spirit	Shrieking vengeance ages like fine wine, if wine could tear limbs.	true
character_skills_localised_name_nag_skill_army_buff_construct	Corrupted Stone	true
character_skills_localised_description_nag_skill_army_buff_construct	Not even stone is set in stone it seems â€“ arcane death magic is used to bring tortured, savage vigour to once-dormant stone sentinels.	true
character_skills_localised_name_nag_skill_army_buff_vet_vamp	Onslaught of Sylvania	true
character_skills_localised_description_nag_skill_army_buff_vet_vamp	The Vampires of the north may be arrogant fools, but their armies can be swift and violent.	true
character_skills_localised_name_nag_skill_army_buff_vet_nehek	Dark Legions of Nehekhara	true
character_skills_localised_description_nag_skill_army_buff_vet_nehek	The once and ever powerful legions of the valley, from the stalwart pawn to the mighty knight, march and fight as one for the Great Necromancer.	true
character_skills_localised_name_nag_skill_army_buff_vet_coast	Rotten Enforcers	true
character_skills_localised_description_nag_skill_army_buff_vet_coast	Luthor's thralls may not be the most solid-looking bunch, but there is hidden worth even in the soggiest zombie.	true
character_skills_localised_name_nag_skill_army_buff_vet_nagash	Vengeance of Nagashizzar	true
character_skills_localised_description_nag_skill_army_buff_vet_nagash	The long-waiting sentinels of the fortress, bolstered once again by their master, march as the best of his troops.	true
character_skills_localised_name_nag_skill_campaign_movement	The Restless Dead	true
character_skills_localised_description_nag_skill_campaign_movement	A Lord of Undeath's minions do not suffer exhaustion, they can walk for leagues and never suffer.	true
character_skills_localised_name_nag_skill_campaign_corruption	Glory of Nagash	true
character_skills_localised_description_nag_skill_campaign_corruption	Speak these words and watch the landscape around you twist and crack, corrupted by his name alone.	true
character_skills_localised_name_nag_skill_campaign_raiding	Soul Harvester	true
character_skills_localised_description_nag_skill_campaign_raiding	More valuable than gold or jewels, the greatest spoils of war are the lifeforces that own them.	true
character_skills_localised_name_nag_skill_campaign_replenishment	Undying Horde	true
character_skills_localised_description_nag_skill_campaign_replenishment	Once slain in battle, the foe belongs to the Undead Lord, and will rise again, eager to serve.	true
character_skills_localised_name_nag_skill_campaign_growth	Dark Conduit	true
character_skills_localised_description_nag_skill_campaign_growth	The corrupting influence of Dark Magic emanates from this lord like a beacon to all shadowy and otherworldy beings.	true
character_skills_localised_name_nag_skill_campaign_recruit	Endless Undeath	true
character_skills_localised_description_nag_skill_campaign_recruit	All creatures that once were living, then were dead, but now are neither, rise to answer the call of the Lord of Undeath	true
character_skills_localised_name_nag_skill_campaign_attrition	Imperishable	true
character_skills_localised_description_nag_skill_campaign_attrition	By which the Undead armies of Nagash may remain deathless, undying and forever hungry for slaughter.	true
character_skills_localised_name_nag_skill_campaign_loot	All is Mine!	true
character_skills_localised_description_nag_skill_campaign_loot	To the victor, the spoils. All of them. Always.	true
character_skills_localised_name_nag_skill_campaign_ambush	Eternal and Vigilant	true
character_skills_localised_description_nag_skill_campaign_ambush	They stand watch over the land, ever living, ever vigilant waiting for opportunistic agents who dare to strike.	true
character_skills_localised_name_nag_skill_campaign_self_defense	Renowned & Feared	true
character_skills_localised_description_nag_skill_campaign_self_defense	This Lord's many deeds - both on and off the battlefield - have brought them renown among their allies and made them feared by their enemies.	true
character_skills_localised_name_nag_skill_campaign_jolly_roger	Black Flag	true
character_skills_localised_description_nag_skill_campaign_jolly_roger	Beware those who sail under the black flag - they give no quarter and never, ever give up the chase.	true
character_skills_localised_name_nag_skill_campaign_immortal_horror	Immortal Horror	true
character_skills_localised_description_nag_skill_campaign_immortal_horror	Such a beast is all but impossible to destroy - an immortal horror doomed to haunt eternity!	true
character_skills_localised_name_nag_skill_campaign_nagash_big_corruption	Glory to Me!	true
character_skills_localised_description_nag_skill_campaign_nagash_big_corruption	"In that dread desert, beneath the moon's pale gaze, dead men walk. They haunt the shifting dunes of the breathless, windless night, brandish weapons of bronze in mocking challenge and bitter resentment of the life they no longer possess. And sometimes, in ghastly dry voices, like the rustling of sun-baked reeds, they whisper the one word they remember from life. The name of the one who cursed them to their existence, more than death but less than life. They whisper the name, Nagash..."	true
character_skills_localised_name_nag_skill_campaign_nagash_big_raiding	Soul Harvester	true
character_skills_localised_description_nag_skill_campaign_nagash_big_raiding	More valuable than gold or jewels, the greatest spoils of war are the lifeforces that own them.	true
character_skills_localised_name_nag_skill_campaign_nagash_big_replenishment	Undying Horde	true
character_skills_localised_description_nag_skill_campaign_nagash_big_replenishment	Once slain in battle, the foe belongs to the Undead Lord, and will rise again, eager to serve.	true
character_skills_localised_name_nag_skill_campaign_nagash_big_growth	Dark Conduit	true
character_skills_localised_description_nag_skill_campaign_nagash_big_growth	The corrupting influence of Dark Magic emanates from this lord like a beacon to all shadowy and otherworldy beings.	true
character_skills_localised_name_nag_skill_campaign_nagash_big_recruit	Endless Undeath	true
character_skills_localised_description_nag_skill_campaign_nagash_big_recruit	All creatures that once were living, then were dead, but now are neither, rise to answer the call of the Lord of Undeath	true
character_skills_localised_name_nag_skill_campaign_nagash_big_attrition	Imperishable	true
character_skills_localised_description_nag_skill_campaign_nagash_big_attrition	By which the Undead armies of Nagash may remain deathless, undying and forever hungry for slaughter.	true
character_skills_localised_name_nag_skill_campaign_nagash_big_loot	All is Mine!	true
character_skills_localised_description_nag_skill_campaign_nagash_big_loot	To the victor, the spoils. All of them. Always.	true
character_skills_localised_name_nag_skill_campaign_nagash_big_ambush	Eternal and Vigilant	true
character_skills_localised_description_nag_skill_campaign_nagash_big_ambush	They stand watch over the land, ever living, ever vigilant waiting for opportunistic agents who dare to strike.	true
character_skills_localised_name_nag_skill_campaign_nagash_big_self_defense	Death & Undeath	true
character_skills_localised_description_nag_skill_campaign_nagash_big_self_defense	Those who walk the lands of the dead soon meet death, then undeath.	true
character_skills_localised_name_nag_skill_campaign_nagash_small_corruption	Glory to Me!	true
character_skills_localised_description_nag_skill_campaign_nagash_small_corruption	"In that dread desert, beneath the moon's pale gaze, dead men walk. They haunt the shifting dunes of the breathless, windless night, brandish weapons of bronze in mocking challenge and bitter resentment of the life they no longer possess. And sometimes, in ghastly dry voices, like the rustling of sun-baked reeds, they whisper the one word they remember from life. The name of the one who cursed them to their existence, more than death but less than life. They whisper the name, Nagash..."	true
character_skills_localised_name_nag_skill_campaign_nagash_small_raiding	Soul Harvester	true
character_skills_localised_description_nag_skill_campaign_nagash_small_raiding	More valuable than gold or jewels, the greatest spoils of war are the lifeforces that own them.	true
character_skills_localised_name_nag_skill_campaign_nagash_small_replenishment	Undying Horde	true
character_skills_localised_description_nag_skill_campaign_nagash_small_replenishment	Once slain in battle, the foe belongs to the Undead Lord, and will rise again, eager to serve.	true
character_skills_localised_name_nag_skill_campaign_nagash_small_growth	Dark Conduit	true
character_skills_localised_description_nag_skill_campaign_nagash_small_growth	The corrupting influence of Dark Magic emanates from this lord like a beacon to all shadowy and otherworldy beings.	true
character_skills_localised_name_nag_skill_campaign_nagash_small_recruit	Endless Undeath	true
character_skills_localised_description_nag_skill_campaign_nagash_small_recruit	All creatures that once were living, then were dead, but now are neither, rise to answer the call of the Lord of Undeath	true
character_skills_localised_name_nag_skill_campaign_nagash_small_attrition	Imperishable	true
character_skills_localised_description_nag_skill_campaign_nagash_small_attrition	By which the Undead armies of Nagash may remain deathless, undying and forever hungry for slaughter.	true
character_skills_localised_name_nag_skill_campaign_nagash_small_loot	All is Mine!	true
character_skills_localised_description_nag_skill_campaign_nagash_small_loot	To the victor, the spoils. All of them. Always.	true
character_skills_localised_name_nag_skill_campaign_nagash_small_ambush	Eternal and Vigilant	true
character_skills_localised_description_nag_skill_campaign_nagash_small_ambush	They stand watch over the land, ever living, ever vigilant waiting for opportunistic agents who dare to strike.	true
character_skills_localised_name_nag_skill_campaign_nagash_small_self_defense	Death & Undeath	true
character_skills_localised_description_nag_skill_campaign_nagash_small_self_defense	Those who walk the lands of the dead soon meet death, then undeath.	true
character_skills_localised_name_nag_skill_magic_nagash_dummy_raise_the_dead	Raise The Dead [HIDDEN]	true
character_skills_localised_description_nag_skill_magic_nagash_dummy_raise_the_dead	[PH]	true
character_skills_localised_name_nag_skill_wh_main_spell_nagash_abyssal_swarm	Razkhar, the Abyssal Swarm	true
character_skills_localised_description_nag_skill_wh_main_spell_nagash_abyssal_swarm		true
character_skills_localised_name_nag_skill_wh_main_spell_nagash_breath_of_darkness	Morkharn, the Breath of Darkness	true
character_skills_localised_description_nag_skill_wh_main_spell_nagash_breath_of_darkness		true
character_skills_localised_name_nag_skill_wh_main_spell_nagash_soul_stealer	Khizaar, the Soul Stealer	true
character_skills_localised_description_nag_skill_wh_main_spell_nagash_soul_stealer		true
character_skills_localised_name_nag_skill_wh_main_spell_nagash_dark_riders	Akar'aran, the Dark Riders	true
character_skills_localised_description_nag_skill_wh_main_spell_nagash_dark_riders		true
character_skills_localised_name_nag_skill_wh_main_spell_nagash_grave_call_master	Ryze, the Grave Call	true
character_skills_localised_description_nag_skill_wh_main_spell_nagash_grave_call_master		true
character_skills_localised_name_nag_skill_wh_main_spell_nagash_hand_of_dust	Sulekhim, the Hand of Dust	true
character_skills_localised_description_nag_skill_wh_main_spell_nagash_hand_of_dust		true
character_skills_localised_name_nag_skill_wh_main_spell_nagash_harbinger	Kandorak, the Harbinger	true
character_skills_localised_description_nag_skill_wh_main_spell_nagash_harbinger		true
character_skills_localised_name_nag_skill_magic_nagash_arch_necromancer	Arch Necromancer	true
character_skills_localised_description_nag_skill_magic_nagash_arch_necromancer	There will be no escape, no blessed oblivion. I can end your life as easily as I can extinguish a candle, and before your corpse is cold, I can reach out and grasp your soul. You will be my slave for all eternity, and I shall laugh at the depths of your pain. Such is the power of Nagash.	true
character_skills_localised_name_nag_skill_magic_nagash_master_arcane_conduit	Master Arcane Conduit	true
character_skills_localised_description_nag_skill_magic_nagash_master_arcane_conduit	"Forces of Necromancy, hear the request of your most-studious adept: flow through me according to my will!"	true
character_skills_localised_name_nag_skill_magic_nagash_death_magic_incarnate	Death Magic Incarnate	true
character_skills_localised_description_nag_skill_magic_nagash_death_magic_incarnate	For generations Nagash was little more than a whisper on the wind of Shyish, but now risen to claim the power of death itself and choke all life from the world, to rule eternally in the darkness.	true
character_skills_localised_name_nag_skill_wh_main_spell_death_spirit_leech	Spirit Leech	true
character_skills_localised_description_nag_skill_wh_main_spell_death_spirit_leech		true
character_skills_localised_name_nag_skill_wh_main_lore_passive_life_leeching	Life-Leeching	true
character_skills_localised_description_nag_skill_wh_main_lore_passive_life_leeching		true
character_skills_localised_name_nag_skill_wh_main_spell_death_soulblight	Soulblight	true
character_skills_localised_description_nag_skill_wh_main_spell_death_soulblight		true
character_skills_localised_name_nag_skill_wh_main_spell_death_the_purple_sun_of_xereus	The Purple Sun of Xereus	true
character_skills_localised_description_nag_skill_wh_main_spell_death_the_purple_sun_of_xereus		true
character_skills_localised_name_nag_skill_wh_main_spell_vampires_gaze_of_nagash	Gaze of Nagash	true
character_skills_localised_description_nag_skill_wh_main_spell_vampires_gaze_of_nagash		true
character_skills_localised_name_nag_skill_wh_main_lore_passive_the_curse_of_undeath	The Curse of Undeath	true
character_skills_localised_description_nag_skill_wh_main_lore_passive_the_curse_of_undeath		true
character_skills_localised_name_nag_skill_wh_main_spell_vampires_invocation_of_nehek	Invocation of Nehek	true
character_skills_localised_description_nag_skill_wh_main_spell_vampires_invocation_of_nehek		true
character_skills_localised_name_nag_skill_wh_main_spell_vampires_wind_of_death	Wind of Death	true
character_skills_localised_description_nag_skill_wh_main_spell_vampires_wind_of_death		true
character_skills_localised_name_nag_skill_wh_main_spell_nehekhara_djafs_incantation_of_cursed_blades	Djaf's Incantation of Cursed Blades	true
character_skills_localised_description_nag_skill_wh_main_spell_nehekhara_djafs_incantation_of_cursed_blades		true
character_skills_localised_name_nag_skill_wh_main_lore_passive_the_restless_dead	The Restless Dead	true
character_skills_localised_description_nag_skill_wh_main_lore_passive_the_restless_dead		true
character_skills_localised_name_nag_skill_wh_main_spell_nehekhara_sakhmets_incantation_of_the_skullstorm	Sakhmet's Incantation of the Skullstorm	true
character_skills_localised_description_nag_skill_wh_main_spell_nehekhara_sakhmets_incantation_of_the_skullstorm		true
character_skills_localised_name_nag_skill_wh_main_spell_nehekhara_usirians_incantation_of_vengeance	Usirian's Incantation of Vengeance	true
character_skills_localised_description_nag_skill_wh_main_spell_nehekhara_usirians_incantation_of_vengeance		true
character_skills_localised_name_nag_skill_wh_main_spell_light_banishment	Banishment	true
character_skills_localised_description_nag_skill_wh_main_spell_light_banishment		true
character_skills_localised_name_nag_skill_wh_main_lore_passive_exorcism	Exorcism	true
character_skills_localised_description_nag_skill_wh_main_lore_passive_exorcism		true
character_skills_localised_name_nag_skill_wh_main_spell_light_bironas_timewarp	Birona's Timewarp	true
character_skills_localised_description_nag_skill_wh_main_spell_light_bironas_timewarp		true
character_skills_localised_name_nag_skill_wh_main_spell_light_shems_burning_gaze	Shem's Burning Gaze	true
character_skills_localised_description_nag_skill_wh_main_spell_light_shems_burning_gaze		true
character_skills_localised_name_nag_skill_magic_nagash_dummy_breath_of_darkness	Breath of Darkness [HIDDEN]	true
character_skills_localised_description_nag_skill_magic_nagash_dummy_breath_of_darkness		true
character_skills_localised_name_nag_skill_magic_nagash_dummy_spirit_leech_gaze_of_nagash	Gaze of Nagash [HIDDEN]	true
character_skills_localised_description_nag_skill_magic_nagash_dummy_spirit_leech_gaze_of_nagash		true
character_skills_localised_name_nag_skill_magic_nagash_dummy_cursed_blades_banishment	Cursed Blades [HIDDEN]	true
character_skills_localised_description_nag_skill_magic_nagash_dummy_cursed_blades_banishment		true
character_skills_localised_name_nag_skill_unique_nagash_book_one	First Book of Nagash	true
character_skills_localised_description_nag_skill_unique_nagash_book_one		true
character_skills_localised_name_nag_skill_unique_nagash_book_two	Second Book of Nagash	true
character_skills_localised_description_nag_skill_unique_nagash_book_two		true
character_skills_localised_name_nag_skill_unique_nagash_book_three	Third Book of Nagash	true
character_skills_localised_description_nag_skill_unique_nagash_book_three		true
character_skills_localised_name_nag_skill_unique_nagash_book_four	Fourth Book of Nagash	true
character_skills_localised_description_nag_skill_unique_nagash_book_four		true
character_skills_localised_name_nag_skill_unique_nagash_book_five	Fifth Book of Nagash	true
character_skills_localised_description_nag_skill_unique_nagash_book_five		true
character_skills_localised_name_nag_skill_unique_nagash_book_six	Sixth Book of Nagash	true
character_skills_localised_description_nag_skill_unique_nagash_book_six		true
character_skills_localised_name_nag_skill_unique_nagash_book_seven	Seventh Book of Nagash	true
character_skills_localised_description_nag_skill_unique_nagash_book_seven		true
character_skills_localised_name_nag_skill_unique_nagash_book_eight	Eighth Book of Nagash	true
character_skills_localised_description_nag_skill_unique_nagash_book_eight		true
character_skills_localised_name_nag_skill_unique_nagash_book_nine	Ninth Book of Nagash	true
character_skills_localised_description_nag_skill_unique_nagash_book_nine		true
character_skills_localised_name_nag_skill_personal_nagash_supreme_lord	Supreme Lord of Undeath	true
character_skills_localised_description_nag_skill_personal_nagash_supreme_lord	The Supreme Lord of Undeath, the ultimate personification of death and the undead, an ancient, evil being who seeks to conquer this cruel, chaotic world and bring about an age of undeath that will rule for all eternity.	true
character_skills_localised_name_nag_skill_personal_nagash_undying_king	Undying King	true
character_skills_localised_description_nag_skill_personal_nagash_undying_king	"Rise! The Undying King commands you! Come to me! "	true
character_skills_localised_name_nag_skill_personal_nagash_great_necromancer	Great Necromancer	true
character_skills_localised_description_nag_skill_personal_nagash_great_necromancer	"There will be no escape, no blessed oblivion. I can end your life as easily as I can extinguish a candle, and before your corpse is cold, I can reach out and grasp your soul. You will be my slave for all eternity, and I shall laugh at the depths of your pain. Such is the power of Nagash."	true
character_skills_localised_name_nag_skill_personal_nagash_world_at_peace	Death is Peace	true
character_skills_localised_description_nag_skill_personal_nagash_world_at_peace	"The dead do not squabble as this landâ€™s rulers do. The dead do not fight one another. The dead have no desires, no petty jealousies or ambitions. A world of the dead is a world at peace..."	true
character_skills_localised_name_nag_skill_personal_nagash_fate_of_flesh	The Fate of Flesh	true
character_skills_localised_description_nag_skill_personal_nagash_fate_of_flesh	"See the fate of all flesh and know despair!"	true
character_skills_localised_name_nag_skill_unique_nagash_morikhane	Morikhane â€“ Black Armour of Nagash	true
character_skills_localised_description_nag_skill_unique_nagash_morikhane	 Nagash's armour is forged from an alloy of lead and meteoric iron. Over the millennia the armour has fused itself with his body, so it may only be worn by Nagash. Obviously, the armour does not prevent him casting spells.	true
character_skills_localised_name_nag_skill_unique_nagash_mortis	Mortis â€“ The Great Blade of Death	true
character_skills_localised_description_nag_skill_unique_nagash_mortis	Mortis is a huge magic sword that crackles with unearthly power. The blade was forged and enchanted by Nagash himself and no-one else may use it. The sword increases his already considerable strength, and wounds caused by the sword can be used to heal Nagash himself.	true
character_skills_localised_name_nag_skill_unique_nagash_nine_books	Nine Books of Nagash	true
character_skills_localised_description_nag_skill_unique_nagash_nine_books	Nagash was the first and greatest of all the Necromancers, and he created almost all of the spells that allow these followers of the dark arts to raise and control the Undead. The secrets of his magical spells are recorded in nine massive tomes known as the Nine Books of Nagash. Each book contains the secrets of one of Nagash's Necromantic spells.	true
character_skills_localised_name_nag_skill_unique_nagash_alakanash	Alakanash â€“ Staff of Power	true
character_skills_localised_description_nag_skill_unique_nagash_alakanash	The Staff of Power was created by Nagash to allow him to store the additional power he needed to carry out his most arcane and dangerous magical spells.	true
character_skills_localised_name_nag_skill_unique_nagash_crown	The Crown of Sorcery	true
character_skills_localised_description_nag_skill_unique_nagash_crown	The Crown of Sorcery sometimes known as the Crown of Nagash is a magical crown/circlet forged by the great Necromancer Nagash around -1300 IC in his fortress of Nagashizzar in Cripple Peak. The crown is infused with part of Nagash's malicious spirit, partially holding his spirit to the mortal world, and exerts a corrupting influence on anyone who wears it.	true
character_skills_localised_name_nag_skill_personal_arkhan_unique_3	Legions of Death	true
character_skills_localised_description_nag_skill_personal_arkhan_unique_3	Although not as numerous as Settra's grand army, Arkhan's Undead legions are bolstered by the Liche King's unparalleled necromantic dexterity.	true
character_skills_localised_name_nag_skill_personal_arkhan_unique_4	Liche King	true
character_skills_localised_description_nag_skill_personal_arkhan_unique_4	The monarch of the Undead, the liege of the Unliving.	true
character_skills_localised_name_nag_skill_personal_arkhan_unique_5	Right-Hand of Nagash	true
character_skills_localised_description_nag_skill_personal_arkhan_unique_5	The first and most loyal of the Great Necromancer's followers will stand at his side once again. So it is writtenâ€¦	true
character_skills_localised_name_nag_skill_self_luthor_smuggler	Smuggler	true
character_skills_localised_description_nag_skill_self_luthor_smuggler	If there's duty to be paid, rest assured that this one will find a way around it.	true
character_skills_localised_name_nag_skill_self_luthor_arsonist	Arsonist	true
character_skills_localised_description_nag_skill_self_luthor_arsonist	Fire, to destroy all that you have done; fire, to end all you've become.	true
character_skills_localised_name_nag_skill_personal_luthor_man_of_war	Man-o-War	true
character_skills_localised_description_nag_skill_personal_luthor_man_of_war	Some seafarers appear to have been born for the role.	true
character_skills_localised_name_nag_skill_personal_luthor_hand_cannon	Hand Cannon	true
character_skills_localised_description_nag_skill_personal_luthor_hand_cannon	By which death is expertly dealt, assuming it doesn't blow your hand off in the process!	true
character_skills_localised_name_nag_skill_personal_luthor_pirate_king	Pirate King	true
character_skills_localised_description_nag_skill_personal_luthor_pirate_king	His crimes are without number and his villainy without endâ€¦ behold the Pirate King!	true
character_skills_localised_name_nag_skill_self_krell_hatred_of_the_gods	Hatred of the Gods	true
character_skills_localised_description_nag_skill_self_krell_hatred_of_the_gods	No longer a plaything of Gods, take their given many gifts, including formidable fighting skills and strike at them!	true
character_skills_localised_name_nag_skill_personal_krell_immortal_challenger	Immortal Challenger	true
character_skills_localised_description_nag_skill_personal_krell_immortal_challenger	Having forever escaped the shackles of mortality, with Nagash's assistance, Krell will never stop - he'll keep coming back until they're all *very* dead!	true
character_skills_localised_name_nag_skill_personal_krell_champion_of_nagash	Champion of Nagash	true
character_skills_localised_description_nag_skill_personal_krell_champion_of_nagash	Nagash's great champion, Krell, a raging spirit within ancient bones, clad in dark enchanted armour. A Berserker tactician with the power of immortality. Victory is certain with this herald of slaughter.	true
character_skills_localised_name_nag_skill_personal_krell_might_makes_wight	Might Makes Wight	true
character_skills_localised_description_nag_skill_personal_krell_might_makes_wight	Woe to the conquered, in a world where "might makes right" be mighty enough to conquer death.	true
character_skills_localised_name_nag_skill_personal_krell_spectral_executioner	Spectral Executioner	true
character_skills_localised_description_nag_skill_personal_krell_spectral_executioner	Krell beat death long before even Nagash had found him, appearing as a Spectral Executioner offering battle to any who'd face him slaying all who matched blades with the ghost.	true
character_skills_localised_name_nag_skill_personal_krell_skull_throne	Skulls for the Skull Throne	true
character_skills_localised_description_nag_skill_personal_krell_skull_throne	So many skulls did Krell lay at Khorne's feet, so much blood did he spill in his name. Old habits die hard, yet it is not Khorne's Skull Throne that piles ever higher it's the Supreme Lord of Undeath's.	true
character_skills_localised_name_nag_skill_personal_krell_abandoned_by_khorne	Forsaken by Khorne	true
character_skills_localised_description_nag_skill_personal_krell_abandoned_by_khorne	When Krell perished there was no dark trumpet call, no chariot of brass to bear his spirit to an eternity of battle. There was just the cold, wet hillside and the cheering of his foes.	true
character_skills_localised_name_nag_skill_personal_krell_the_doomed_legion	The Doomed Legion	true
character_skills_localised_description_nag_skill_personal_krell_the_doomed_legion	Commander of the Doomed Legion, raised by Nagash as Krell's personal minions, they serve in the forefront of Nagash's battles refusing to give ground, enduring, undying.	true
character_skills_localised_name_nag_skill_personal_krell_his_will_be_done	His Will be Done	true
character_skills_localised_description_nag_skill_personal_krell_his_will_be_done	Krell hears Nagash's ghostly voice with a clarity matched by none save Arkhan the Black, and he obey's his master without hesitation. Where Krell walks, it is Nagash's will that is done.	true
character_skills_localised_name_nag_skill_personal_neferata_deathly_vigour	Deathly Vigour	true
character_skills_localised_description_nag_skill_personal_neferata_deathly_vigour	If anything, this one has an even greater lust for life than they did before their death.	true
character_skills_localised_name_nag_skill_personal_neferata_twilights_allure	Twilights Allure	true
character_skills_localised_description_nag_skill_personal_neferata_twilights_allure	"One hundred and thirty-six of her followers have raised armies, fleets and beasts to hurl themselves against my walls. They come from north, east, south. sea, sky and sand, from the jungles and the mountains too. They pour forth in a limitless tide and they are broken on my walls."	true
character_skills_localised_name_nag_skill_personal_neferata_queen_of_mysteries	Queen of Mysteries	true
character_skills_localised_description_nag_skill_personal_neferata_queen_of_mysteries	Ancient, powerful, beautiful, seductive and cunning, traits that give the Queen of Mysteries advantage on the battlefied with both blade and tongue.	true
character_skills_localised_name_nag_skill_personal_neferata_first_of_vampires	First of the Vampires	true
character_skills_localised_description_nag_skill_personal_neferata_first_of_vampires	Queen of Lahmia and First of the Vampires, Neferata distiled an Elixer of Life which cursed her for all eternity. Neferata and her court became stricken by an unquenchable thirst for mortal blood. Lahmia became the birthplace of the Vampires.	true
character_skills_localised_name_nag_skill_personal_neferata_grand_masquerade	The Grand Masquerade	true
character_skills_localised_description_nag_skill_personal_neferata_grand_masquerade	"You are a greater fool than even I believed, and never shall you join my kin. We are guests at the ultimate masquerade, and your kind is simply not invited."	true
character_skills_localised_name_nag_skill_personal_neferata_web_of_spies	Web of Spies	true
character_skills_localised_description_nag_skill_personal_neferata_web_of_spies	"Behind every great man is a great woman. And behind those great women is me."	true
character_skills_localised_name_nag_skill_unique_arkhan_staff_of_nagash	Staff of Nagash	true
character_skills_localised_description_nag_skill_unique_arkhan_staff_of_nagash	Created by the Arch-Necromancer, the staff harnesses Dark Magic from deep within the accursed Black Pyramid.	true
character_skills_localised_name_nag_skill_unique_arkhan_the_tomb_blade_of_arkhan	The Tomb Blade of Arkhan	true
character_skills_localised_description_nag_skill_unique_arkhan_the_tomb_blade_of_arkhan	The sword burns away the flesh of Arkhan's victims, leaving nothing but a charred skeleton, bound to the Liche King's dark will for all eternity.	true
character_skills_localised_name_nag_skill_unique_vlad_blood_drinker	Blood Drinker	true
character_skills_localised_description_nag_skill_unique_vlad_blood_drinker	This accursed blade drinks deep of its victim's blood, restoring vigour and strength to the one who brandishes it.	true
character_skills_localised_name_nag_skill_unique_vlad_the_carstein_ring	The Carstein Ring 	true
character_skills_localised_description_nag_skill_unique_vlad_the_carstein_ring	An ancestral ring, set with a gem of deep, sanguine claret that has granted the von Carsteins everlasting Undeath.	true
character_skills_localised_name_nag_skill_unique_vlad_von_carstein_mesmerising_aura	Mesmerising Aura 	true
character_skills_localised_description_nag_skill_unique_vlad_von_carstein_mesmerising_aura	The Lord of the von Carsteins exudes a distracting and sensational air, giving all before him pause.	true
character_skills_localised_name_nag_skill_unique_luthor_slann_gold	Slann Gold	true
character_skills_localised_description_nag_skill_unique_luthor_slann_gold	It is well known that Lustrian gold is enchanted with all manner of esoteric properties; Harkon thinks it will restore his fractured mind! 	true
character_skills_localised_name_nag_skill_unique_krell_chaos_tomb_blade	Chaos Tomb Blade	true
character_skills_localised_description_nag_skill_unique_krell_chaos_tomb_blade	This evil weapon not only fills its wielder with an unholy energy but also entraps the souls of those it cleaves, binding their jleshless remains in servitude.	true
character_skills_localised_name_nag_skill_unique_krell_armour_of_the_barrows	Armour of the Barrows	true
character_skills_localised_description_nag_skill_unique_krell_armour_of_the_barrows	The passage of the ages has strengthened rather than weakened this elaborate Chaos plate armour. Such is the aura of entropy that surrounds it that it has the power to decay the magic of enemy weapons in an instant.	true
character_skills_localised_name_nag_skill_unique_krell_black_axe_of_krell	The Black Axe of Krell	true
character_skills_localised_description_nag_skill_unique_krell_black_axe_of_krell	When the Black Axe of Krell bites into flesh, it leaves behind jagged shards that swiftly eat their way into the victim's heart.	true
character_skills_localised_name_nag_skill_unique_neferatal_dagger_of_jet	Dagger of Jet	true
character_skills_localised_description_nag_skill_unique_neferatal_dagger_of_jet	Akmet-kar, the Dagger of Jet whose cursed edge screams with the death agonies of innocents and saps the vitality and fighting spirit of its victims.	true
character_skills_localised_name_nag_skill_unique_neferatal_staff_of_pain	Staff of Pain	true
character_skills_localised_description_nag_skill_unique_neferatal_staff_of_pain	Aken-seth, the Staff of Pain, whose enchantments add crippling agonies to any sorceries she wields.	true
character_skills_localised_name_nag_skill_unique_mannfred_armour_of_templehof	Armour of Templehof	true
character_skills_localised_description_nag_skill_unique_mannfred_armour_of_templehof	A product of twisted sorcery, this construct fu ses with the wearer, giving him tremendous endurance. 	true
character_skills_localised_name_nag_skill_unique_mannfred_sword_of_unholy_power	Sword of Unholy Power	true
character_skills_localised_description_nag_skill_unique_mannfred_sword_of_unholy_power	Whenever this blade tastes blood, its wielder seems to exert greater control over the vvtnds of Magic. 	true
character_skills_localised_name_nag_skill_unique_isabella_blood_chalice_of_bathori	Blood Chalice of Bathori	true
character_skills_localised_description_nag_skill_unique_isabella_blood_chalice_of_bathori	The life essence of many wretched, innocent smallfolk ensures that those who drink from this cursed cup thrive with newfound power.	true
character_skills_localised_name_nag_skill_mount_isabella_hellsteed	Hellsteed	true
character_skills_localised_description_nag_skill_mount_isabella_hellsteed	"To me, my winged steed of bone and flesh; let us fly and remake the world together!"	true
character_skills_localised_name_nag_skill_mount_isabella_barded_nightmare	Barded Nightmare	true
character_skills_localised_description_nag_skill_mount_isabella_barded_nightmare	The most impressive Nightmares are those reared on fresh blood. Such noble monstrosities are worthy mounts.	true
character_skills_localised_name_nag_skill_mount_arkhan_abyssal	Razarak, The Doom of Traitors	true
character_skills_localised_description_nag_skill_mount_arkhan_abyssal	The dread abyssal ridden by Arkhan the Black was known to myth as Razarak. Whilst other dread abyssals scoured the depths of the Underworld, Razarak always sought lofty perches from which to track its prey. Such behavior was well-suited to its duties, for treachery is best judged from on high.	true
character_skills_localised_name_nag_skill_mount_mannfred_abyssal	Ashigaroth, Gourger Upon the Meek	true
character_skills_localised_description_nag_skill_mount_mannfred_abyssal	The dread abyssal ridden by Mannfred von Carstein was known to myth as Ashigaroth. Now reborn as a creature of chill bone in the mortal world, Ashigaroth hunts the living as readily as it ever did the dead, galloping through the skies to follow the spirit-spoor of prey.	true
character_skills_localised_name_nag_skill_mount_neferata_abyssal	Nagadron, The Adevore	true
character_skills_localised_description_nag_skill_mount_neferata_abyssal	The dread abyssal ridden by Neferata was known to myth as Nagadron. So voracious is Nagadron that it needs little goading to feast upon other prey, and gorges itself upon the living as eagerly as it did the souls of the dead.	true
character_skills_localised_name_nag_skill_mount_arkhan_skeletal_steed	Skeletal Steed	true
character_skills_localised_description_nag_skill_mount_arkhan_skeletal_steed	Long-dead destriers, awakened to serve their Unliving masters far beyond death.	true
character_skills_localised_name_nag_skill_mount_arkhan_skeleton_chariot	Skeleton Chariot	true
character_skills_localised_description_nag_skill_mount_arkhan_skeleton_chariot	The pride of Nehekharan armies, impacting enemy lines with bone-shattering force and grinding the corpses beneath their heavy wheels.	true
character_skills_localised_name_nag_skill_mount_mannfred_barded_nightmare	Barded Nightmare	true
character_skills_localised_description_nag_skill_mount_mannfred_barded_nightmare	Mannfred can ride an armoured steed of defiled flesh and bone; such an abominable horse is known as a 'Nightmare'.	true
character_skills_localised_name_nag_skill_mount_neferata_warhorse	Barded Nightmare	true
character_skills_localised_description_nag_skill_mount_neferata_warhorse	Neferata can ride an armoured steed of defiled flesh and bone; such an abominable horse is known as a 'Nightmare'.	true
character_skills_localised_name_nag_skill_mount_luthor_harkon_terrorgheist	Death Shriek Terrorgheist	true
character_skills_localised_description_nag_skill_mount_luthor_harkon_terrorgheist	Harkon's personal mount is a dreadful thing indeed - a Terrorgheist with a piercing, banshee-like shriek that has the power to stun any who hear it.	true
character_skills_localised_name_nag_skill_supreme_innate_nagash	Supreme Lord of Undeath	true
character_skills_localised_description_nag_skill_supreme_innate_nagash	Nagash, known by many names such as the Great Necromancer, the Great Betrayer, the Usurper, the Undying King, the Lord of Undead, He Who Shall Not Be Named or simply Bone Daddy.	true
character_skills_localised_name_nag_skill_husk_innate_nagash	The Undying King	true
character_skills_localised_description_nag_skill_husk_innate_nagash	The husk of Nagash has sat on his throne of skulls for over a millennium, brooding, waiting and planning. The pieces are all in place and the day has come that he re-emerges from his citadel to conquer the world.	true
character_skills_localised_name_nag_skill_mortarch_innate_arkhan	Mortarch of Sacrament	true
character_skills_localised_description_nag_skill_mortarch_innate_arkhan	Thousands of years plotting, misleading, waiting for His return. The First of the Mortarchs finally reaps his rewards.	true
character_skills_localised_name_nag_skill_mortarch_innate_krell	Mortarch of Despair	true
character_skills_localised_description_nag_skill_mortarch_innate_krell	Once a servant of Khorne, then Kemmler. Always the unsleeping agent marked for Nagash's future plans.	true
character_skills_localised_name_nag_skill_mortarch_innate_vlad	Mortarch of Shadow	true
character_skills_localised_description_nag_skill_mortarch_innate_vlad	Perhaps the most unwilling of the Mortarchs, Vashanesh is cursed with blood, bound with a ring, enthralled by promises.	true
character_skills_localised_name_nag_skill_mortarch_innate_mannfred	Mortarch of Night	true
character_skills_localised_description_nag_skill_mortarch_innate_mannfred	Powerful, ambitious, unreliable... but definitely surpassed.	true
character_skills_localised_name_nag_skill_mortarch_innate_luthor	Mortarch of the Abyss	true
character_skills_localised_description_nag_skill_mortarch_innate_luthor	"Truth be told, one of us thought he had a really fancy hat."	true
character_skills_localised_name_nag_skill_mortarch_innate_neferata	Mortarch of Blood	true
character_skills_localised_description_nag_skill_mortarch_innate_neferata	A spider queen, amidst her web of thralls, handmaidens and lies.	true
character_skills_localised_name_nag_skill_mortarch_innate_isabella	The Countess of Sylvania	true
character_skills_localised_description_nag_skill_mortarch_innate_isabella	A vain, immoral, selfish, intelligent and stunning, cold beauty. Vlad's one true love and most valued confidante, and the only person, living or dead, whose advice he trusts.	true
character_skills_localised_name_nag_skill_traitor_kings_innate_first_book	Knowledge of the First Book	true
character_skills_localised_description_nag_skill_traitor_kings_innate_first_book	A gift of knowledge from a single page of one of the nine books of nagash, a taste of power to sate their greed and ensure eternal loyalty.	true
character_skills_localised_name_nag_skill_traitor_kings_innate_second_book	Knowledge of the Second Book	true
character_skills_localised_description_nag_skill_traitor_kings_innate_second_book	A gift of knowledge from a single page of one of the nine books of nagash, a taste of power to sate their greed and ensure eternal loyalty.	true
character_skills_localised_name_nag_skill_traitor_kings_innate_third_book	Knowledge of the Third Book	true
character_skills_localised_description_nag_skill_traitor_kings_innate_third_book	A gift of knowledge from a single page of one of the nine books of nagash, a taste of power to sate their greed and ensure eternal loyalty.	true
character_skills_localised_name_nag_skill_traitor_kings_innate_fouth_book	Knowledge of the Fourth Book	true
character_skills_localised_description_nag_skill_traitor_kings_innate_fouth_book	A gift of knowledge from a single page of one of the nine books of nagash, a taste of power to sate their greed and ensure eternal loyalty.	true
character_skills_localised_name_nag_skill_traitor_kings_innate_fifth_book	Knowledge of the Fifth Book	true
character_skills_localised_description_nag_skill_traitor_kings_innate_fifth_book	A gift of knowledge from a single page of one of the nine books of nagash, a taste of power to sate their greed and ensure eternal loyalty.	true
character_skills_localised_name_nag_skill_traitor_kings_innate_sixth_book	Knowledge of the Sixth Book	true
character_skills_localised_description_nag_skill_traitor_kings_innate_sixth_book	A gift of knowledge from a single page of one of the nine books of nagash, a taste of power to sate their greed and ensure eternal loyalty.	true
character_skills_localised_name_nag_skill_traitor_kings_innate_seventh_book	Knowledge of the Seventh Book	true
character_skills_localised_description_nag_skill_traitor_kings_innate_seventh_book	A gift of knowledge from a single page of one of the nine books of nagash, a taste of power to sate their greed and ensure eternal loyalty.	true
character_skills_localised_name_nag_skill_traitor_kings_innate_eighth_book	Knowledge of the Eighth Book	true
character_skills_localised_description_nag_skill_traitor_kings_innate_eighth_book	A gift of knowledge from a single page of one of the nine books of nagash, a taste of power to sate their greed and ensure eternal loyalty.	true
character_skills_localised_name_nag_skill_traitor_kings_innate_ninth_book	Knowledge of the Ninth Book	true
character_skills_localised_description_nag_skill_traitor_kings_innate_ninth_book	A gift of knowledge from a single page of one of the nine books of nagash, a taste of power to sate their greed and ensure eternal loyalty.	true
character_skills_localised_name_nag_skill_archai_heralds_of_the_accursed_one	Heralds of the Accursed One	true
character_skills_localised_description_nag_skill_archai_heralds_of_the_accursed_one	Once Divine warriors of Ptra, the Hammurai failed in their task of defeating The Supreme Lord of the Undead, Nagash looked upon their corpses of the hammurai and saw opportunity. Thus the Heralds of Accursed One were born.	true
character_skills_localised_name_nag_skill_archai_ebon_wrought_armour	Ebon-wrought Armour	true
character_skills_localised_description_nag_skill_archai_ebon_wrought_armour	The greatest of their number, the Archai - Nagash's elite guard who had been fused from the mightiest of Ptra's heralds have been encased in Ebon-wrought armour to channel the magic of the world into their accursed forms.	true
character_skills_localised_name_nag_skill_archai_undying_servitude	Undying Servitude	true
character_skills_localised_description_nag_skill_archai_undying_servitude	Only Nagash's closest lieutenants can command them; only the mightiest heroes of the mortal races have the power to defeat them. Where they tread, the living perish and the dead awaken. The morghasts are rising, and they are the heralds of death.	true
character_skills_localised_name_nag_skill_archai_gift_of_oblivion	Gift of Oblivion	true
character_skills_localised_description_nag_skill_archai_gift_of_oblivion	Wherever the morghasts fought, they brought the gift of oblivion. The morghasts had no command of sorcery, but so suffused with death magic were they that their mere presence urged the dead to rise.	true
character_skills_localised_name_nag_lord_unique_tomb_king_skeletal_steed	Skeletal Steed	true
character_skills_localised_description_nag_lord_unique_tomb_king_skeletal_steed	Long-dead destriers, awakened to serve their Unliving masters far beyond death.	true
character_skills_localised_name_nag_lord_unique_tomb_king_skeleton_chariot	Skeleton Chariot	true
character_skills_localised_description_nag_lord_unique_tomb_king_skeleton_chariot	The pride of Nehekharan armies, impacting enemy lines with bone-shattering force and grinding the corpses beneath their heavy wheels.	true
character_skills_localised_name_nag_lord_unique_tomb_king_khemrian_warsphinx	Khemrian Warsphinx	true
character_skills_localised_description_nag_lord_unique_tomb_king_khemrian_warsphinx	Giant leonine statues, almost impervious to harm; they wade through foes, crushing them like bothersome insects.	true
character_skills_localised_name_nag_champion_unique_tomb_prince_skeletal_steed	Skeletal Steed	true
character_skills_localised_description_nag_champion_unique_tomb_prince_skeletal_steed	Long-dead destriers, awakened to serve their Unliving masters far beyond death.	true
character_skills_localised_name_nag_champion_unique_tomb_prince_skeleton_chariot	Skeleton Chariot	true
character_skills_localised_description_nag_champion_unique_tomb_prince_skeleton_chariot	The pride of Nehekharan armies, impacting enemy lines with bone-shattering force and grinding the corpses beneath their heavy wheels.	true
character_skills_localised_name_nag_wizard_unique_liche_priest_shadow_skeletal_steed	Skeletal Steed	true
character_skills_localised_description_nag_wizard_unique_liche_priest_shadow_skeletal_steed	Long-dead destriers, awakened to serve their Unliving masters far beyond death.	true
character_skills_localised_name_nag_wizard_unique_liche_priest_death_skeletal_steed	Skeletal Steed	true
character_skills_localised_description_nag_wizard_unique_liche_priest_death_skeletal_steed	Long-dead destriers, awakened to serve their Unliving masters far beyond death.	true
character_skills_localised_name_nag_wizard_unique_liche_priest_nehekhara_skeletal_steed	Skeletal Steed	true
character_skills_localised_description_nag_wizard_unique_liche_priest_nehekhara_skeletal_steed	Long-dead destriers, awakened to serve their Unliving masters far beyond death.	true
character_skills_localised_name_nag_wizard_unique_liche_priest_light_skeletal_steed	Skeletal Steed	true
character_skills_localised_description_nag_wizard_unique_liche_priest_light_skeletal_steed	Long-dead destriers, awakened to serve their Unliving masters far beyond death.	true
character_skills_localised_name_nag_wizard_unique_liche_priest_undeath_skeletal_steed	Skeletal Steed	true
character_skills_localised_description_nag_wizard_unique_liche_priest_undeath_skeletal_steed	Long-dead destriers, awakened to serve their Unliving masters far beyond death.	true
character_skills_localised_name_nag_skill_hero_undeath_spell_nagash_abyssal_swarm	Razkhar, the Abyssal Swarm	true
character_skills_localised_description_nag_skill_hero_undeath_spell_nagash_abyssal_swarm	The wizard binds the bones of predatory creatures with dark magic, causing them to rise from their animal graves.	true
character_skills_localised_name_nag_skill_hero_undeath_spell_magic_nagash_raise_the_dead	Raise The Dead	true
character_skills_localised_description_nag_skill_hero_undeath_spell_magic_nagash_raise_the_dead		true
character_skills_localised_name_nag_skill_hero_undeath_spell_nagash_breath_of_darkness	Morkharn, the Breath of Darkness	true
character_skills_localised_description_nag_skill_hero_undeath_spell_nagash_breath_of_darkness	The wizard draws tendrills of the Wind of Death into a dark fog that restores the undead and fills them with unholy vigour.	true
character_skills_localised_name_nag_skill_hero_undeath_spell_nagash_soul_stealer	Khizaar, the Soul Stealer	true
character_skills_localised_description_nag_skill_hero_undeath_spell_nagash_soul_stealer	The wizard tears the souls from his victims' bodies before breathing unlife into their sundered corpses.	true
character_skills_localised_name_nag_skill_hero_undeath_spell_nagash_dark_riders	Akar'aran, the Dark Riders	true
character_skills_localised_description_nag_skill_hero_undeath_spell_nagash_dark_riders	At the wizard's command, the ground opens up to reveal a portal through which long-dead knights ride forth to do battle.	true
character_skills_localised_name_nag_skill_hero_undeath_spell_nagash_grave_call_master	Ryze, the Grave Call	true
character_skills_localised_description_nag_skill_hero_undeath_spell_nagash_grave_call_master	Drawing forth the dark energy coursing across the land, the caster sends the tendrills of power seeping into the ground in search of long-dead bodies to answer his summons.	true
character_skills_localised_name_nag_skill_hero_undeath_spell_nagash_hand_of_dust	Sulekhim, the Hand of Dust	true
character_skills_localised_description_nag_skill_hero_undeath_spell_nagash_hand_of_dust	Grasping hold of his foe, the wizard pours forth the decaying power of ages, desiccating flesh, armour and bone, and reducing his victim to dust in a single heartbeat.	true
character_skills_localised_name_nag_skill_hero_undeath_spell_nagash_dummy_breath_of_darkness	Morkharn, the Breath of Darkness HIDDEN	true
character_skills_localised_description_nag_skill_hero_undeath_spell_nagash_dummy_breath_of_darkness	The wizard draws tendrills of the Wind of Death into a dark fog that restores the undead and fills them with unholy vigour.	true
character_skills_localised_name_nag_skill_personal_neferata_guardian	Thrall Guardians	true
character_skills_localised_description_nag_skill_personal_neferata_guardian	Never know when you need someone to clean your shoes.	true
character_skills_localised_name_nag_dignitary_shadow_unique_vampire_barded_nightmare	Barded Nightmare	true
character_skills_localised_description_nag_dignitary_shadow_unique_vampire_barded_nightmare	Nightmares are often clad in heavy barding or wear caparisons of thick chainmail.	true
character_skills_localised_name_nag_dignitary_shadow_unique_vampire_hellsteed	Hellsteed	true
character_skills_localised_description_nag_dignitary_shadow_unique_vampire_hellsteed	Hellsteeds are vicious. Vampires that dabble in the binding of beasts delight in breaking these wild creatures to their will.	true
character_skills_localised_name_nag_dignitary_unique_vampire_barded_nightmare	Barded Nightmare	true
character_skills_localised_description_nag_dignitary_unique_vampire_barded_nightmare	Nightmares are often clad in heavy barding or wear caparisons of thick chainmail.	true
character_skills_localised_name_nag_dignitary_unique_vampire_hellsteed	Hellsteed	true
character_skills_localised_description_nag_dignitary_unique_vampire_hellsteed	Hellsteeds are vicious. Vampires that dabble in the binding of beasts delight in breaking these wild creatures to their will.	true
character_skills_localised_name_nag_vmp_champion_unique_wight_king_skeletal_steed	Skeletal Steed	true
character_skills_localised_description_nag_vmp_champion_unique_wight_king_skeletal_steed	Wight Kings require the steeds that bore them in life, and will do again in death.	true
character_skills_localised_name_nag_vmp_champion_unique_wight_king_barded_skeletal_steed	Barded Skeletal Steed	true
character_skills_localised_description_nag_vmp_champion_unique_wight_king_barded_skeletal_steed	Skeletal Steeds draped in fine armour make for an impressive and dangerous sight.	true
character_skills_localised_name_nag_cst_engineer_unique_gunnery_wight_rotting_pro	Rotting Promethean	true
character_skills_localised_description_nag_cst_engineer_unique_gunnery_wight_rotting_pro	The unnatural speed and brutality of a reanimated Promethean makes it the ideal mount for any Undead, battle-mongering pirate.	true
character_skills_localised_name_nag_skill_tomb_king_elixir_of_immortality_lord	Elixir of Immortality	true
character_skills_localised_description_nag_skill_tomb_king_elixir_of_immortality_lord	This complex distillation not only preserves the drinker in glorious Unlife, it also increases their physical resistance to attack.	true
character_skills_localised_name_nag_skill_hidden_king_title	King Title [HIDDEN]	true
character_skills_localised_name_nag_skill_hidden_prince_title	Prince Title [HIDDEN]	true
character_skills_localised_name_nag_skill_all_dummy_agent_actions_liche_priest	Actions [HIDDEN]	true
character_skills_localised_description_nag_skill_all_dummy_agent_actions_liche_priest		true
character_skills_localised_name_nag_skill_all_dummy_agent_actions_archai	Actions [HIDDEN]	true
character_skills_localised_description_nag_skill_all_dummy_agent_actions_archai		true
character_skills_localised_name_nag_skill_vmp_dieter_helsnicht_item_01	Chaos Runesword	false
character_skills_localised_description_nag_skill_vmp_dieter_helsnicht_item_01	This weapon was forged by Grungni Ironheart, a Dwarf Runesmith who was led astray by the Chaos gods.	false
character_skills_localised_name_nag_skill_vmp_dieter_helsnicht_item_02	Staff of Flaming Death	false
character_skills_localised_description_nag_skill_vmp_dieter_helsnicht_item_02	The jaws of the skull at its tip gnash and its eyes glow - it can unleash a torrent of fire.	false
character_skills_localised_name_nag_skill_azhag_anc_armour_azhags_ard_armour	Azhag's 'Ard Armour	false
character_skills_localised_description_nag_skill_azhag_anc_armour_azhags_ard_armour	No ordinary armour would suit a Warboss such as Azhag, it had to be â€˜ard - really, really â€˜ard.	false
character_skills_localised_name_nag_skill_azhag_anc_enchanted_item_the_crown_of_sorcery	The Crown of Sorcery	false
character_skills_localised_description_nag_skill_azhag_anc_enchanted_item_the_crown_of_sorcery	The Crown of Sorcery was found in the ruins of Todtheim by Azhag the Slaughterer. Its malign influence has helped the Warboss carve a path of destruction throughout the Empire, for the Crown whispers advice and grants the wearer the power of Death Magic.	false
character_skills_localised_name_nag_skill_azhag_anc_weapon_slaggas_slashas	Slagga's Slashas	false
character_skills_localised_description_nag_skill_azhag_anc_weapon_slaggas_slashas	The crude twin blades wielded by Azhag the Slaughterer are known as Slaggaâ€™s Slashas, but just who is Slagga?	false
character_skills_localised_name_nag_skill_army_buff_ranged_azhag	Arrows of Nagashizzar	false
character_skills_localised_description_nag_skill_army_buff_ranged_azhag	Asaph may have turned her back on these arrows, but Nagash's hatred is far-reaching.	false
character_skills_localised_name_nag_skill_army_buff_infantry_azhag	Dhar-Scorched Bones	false
character_skills_localised_description_nag_skill_army_buff_infantry_azhag	It can't possibly be worse than this.	false
character_skills_localised_name_nag_skill_army_buff_beasts_azhag	Twisted Malevolence	false
character_skills_localised_description_nag_skill_army_buff_beasts_azhag	Deadly claws, deadly poisons, or both. 	false
character_skills_localised_name_nag_skill_army_buff_construct_azhag	Corrupted Stone	false
character_skills_localised_description_nag_skill_army_buff_construct_azhag	Not even stone is set in stone it seems â€“ arcane death magic is used to bring tortured, savage vigour to once-dormant stone sentinels.	false
character_skills_localised_name_nag_skill_army_buff_vet_nagash_azhag	Vengeance of Nagashizzar	false
character_skills_localised_description_nag_skill_army_buff_vet_nagash_azhag	The long-waiting sentinels of the fortress, bolstered once again by their master, march as the best of his troops.	false
character_skills_localised_name_nag_skill_grn_azhag_unique_0	Imbued by Madness	false
character_skills_localised_description_nag_skill_grn_azhag_unique_0	Held aloft and kept there by the rampant lunacy of their leader, Azhag's forces are all the stronger for his insane presence.	false
character_skills_localised_name_nag_skill_grn_azhag_unique_1	Earthshaking Orders	false
character_skills_localised_description_nag_skill_grn_azhag_unique_1	"Stoopid gits, I sed NOWWWWW!!!!!!!"	false
character_skills_localised_name_nag_skill_grn_azhag_unique_2	Insane Visions	false
character_skills_localised_description_nag_skill_grn_azhag_unique_2	Azhag's mysterious crown whispers fell plans and dastardly schemes; sometimes he understands them most of the time he doesn't.	false
character_skills_localised_name_nag_skill_grn_azhag_unique_3	Not Orcy Enuff!	false
character_skills_localised_description_nag_skill_grn_azhag_unique_3	There are some who whisper that the Slaughterer's wild schemes are not sufficiently Orcy. Needless to say, the crown normally lets him know so he can weed out the dissenters.	false
character_skills_localised_name_nag_skill_grn_azhag_unique_4	Wild Abandon	false
character_skills_localised_description_nag_skill_grn_azhag_unique_4	Enchanted armour and weapons, and the influence of the crown, allows Azhag to 'let go' somewhat on the battlefield!	false
character_skills_localised_name_nag_skill_grn_azhag_unique_5	Darkest Nimbus	false
character_skills_localised_description_nag_skill_grn_azhag_unique_5	When the crown takes control Azhag falls into a trance, his eyes cloud over and he mutters and even argues with himselfâ€¦	false
character_skills_localised_name_nag_skill_grn_azhag_tyrant	Green Tyrant	false
character_skills_localised_description_nag_skill_grn_azhag_tyrant	He's big, he's green and he has the whisperings of a tyrannical lord of the undead in his ear.	false
character_skills_localised_name_nag_skill_personal_neferata_dancer	Dance with the Devil	false
character_skills_localised_description_nag_skill_personal_neferata_dancer	Say goodbye, as we dance with the Devil tonight.	false
character_skills_localised_name_nag_skill_vmp_isabella_unique_court_of_blood	Court of Blood	false
character_skills_localised_description_nag_skill_vmp_isabella_unique_court_of_blood	Even in Undeath, every queen needs loyal retainers and handmaidens.	false
character_skills_localised_name_rhox_nagash_grn_dump		false
character_skills_localised_description_rhox_nagash_grn_dump		false
character_skills_localised_name_nag_skill_innate_vmp_dieter_helsnicht	Mortarch of Doom	false
character_skills_localised_description_nag_skill_innate_vmp_dieter_helsnicht	[PH]Mortarch of Doom	false
character_skills_localised_name_nag_skill_unique_nagash_hate_skaven	A Personal Vendetta	false
character_skills_localised_description_nag_skill_unique_nagash_hate_skaven	THE RATMEN HAVE INTERLOPED TOO OFTEN. THEY DIE.	false
character_skills_localised_name_nag_skill_unique_nagash_hate_daemons	Anathema Chaotica	false
character_skills_localised_description_nag_skill_unique_nagash_hate_daemons	All of Nagash's plans have only one final objective. Cut off the Chaos Gods forever.	false
character_skills_localised_name_nag_skill_unique_nagash_hate_traitors	Despotic Domination	false
character_skills_localised_description_nag_skill_unique_nagash_hate_traitors	They used to be Kings; they're now slaves trapped in the Tombs of their desicated bodies. Obstacles to be pushed aside.	false
character_skills_localised_name_nag_skill_unique_nagash_hate_equal	Inevitable Death	false
character_skills_localised_description_nag_skill_unique_nagash_hate_equal	Death comes to those who wait. And to those who don't. So either wayâ€¦	false
character_skills_localised_name_nag_skill_lahmia_innate_neferata	Queen of the Lahmians	false
character_skills_localised_description_nag_skill_lahmia_innate_neferata	A spider queen, amidst her web of thralls, handmaidens and lies.	false
character_skills_localised_name_nag_skill_mortarch_innate_azhag	Mortarch of "Destruction"	true
character_skills_localised_description_nag_skill_mortarch_innate_azhag	A warlord, a pawn, nothing more than a puppet, dancing to his will.	true
character_skills_localised_name_nag_lord_unique_vampire_lord_barded_nightmare	Barded Nightmare	false
character_skills_localised_description_nag_lord_unique_vampire_lord_barded_nightmare	The most impressive Nightmares are those reared on fresh blood. Such noble monstrosities are worthy mounts.	false
character_skills_localised_name_nag_lord_unique_vampire_lord_hellsteed	Hellsteed	false
character_skills_localised_description_nag_lord_unique_vampire_lord_hellsteed	"To me, my winged steed of bone and flesh; let us fly and remake the world together!"	false
character_skills_localised_name_nag_lord_unique_vampire_lord_zombie_dragon	Zombie Dragon	false
character_skills_localised_description_nag_lord_unique_vampire_lord_zombie_dragon	It is to the Plain of Bones that a Vampire Lord travels to claim a Zombie Dragon as their mount.	false
character_skills_localised_name_nag_lord_unique_master_necromancer_corpse_cart	Corpse Cart	false
character_skills_localised_description_nag_lord_unique_master_necromancer_corpse_cart	Devilish chariots imbued with dark and eldritch power, driving the Undead to greater, more macabre acts.	false
character_skills_localised_name_nag_lord_unique_master_necromancer_corpse_cart_balefire	Corpse Cart (Balefire)	false
character_skills_localised_description_nag_lord_unique_master_necromancer_corpse_cart_balefire	Infernal flames belch from dismal braziers, permeating the air with fragments of magic-confounding Warpstone.	false
character_skills_localised_description_character_skills_localised_name_nag_lord_unique_master_necromancer_corpse_cart_unholy_lodestone	Corpse Cart (Unholy Lodestone)	false
character_skills_localised_description_nag_lord_unique_master_necromancer_corpse_cart_unholy_lodestone	When the lodestone bell rings, Dark Magic exudes and ripples across the battlefield.	false
character_skills_localised_description_character_skills_localised_name_nag_lord_unique_vmp_master_necromancer_barded_nightmare	Barded Nightmare	false
character_skills_localised_description_nag_lord_unique_vmp_master_necromancer_barded_nightmare	It is not just Vampires that can tame a fierce, barded Undead steed - some Necromancers have such power too.	false
character_skills_localised_name_nag_lord_unique_vmp_master_necromancer_hellsteed	Hellsteed	false
character_skills_localised_description_nag_lord_unique_vmp_master_necromancer_hellsteed	Necromancers may summon a Hellsteed, a winged Nightmare, to take them wherever they wish.	false
character_skills_localised_name_nag_lord_unique_master_necromancer_corpse_cart_unholy_lodestone	Corpse Cart (Unholy Lodestone)	false
character_skills_localised_name_nag_lord_unique_vmp_master_necromancer_barded_nightmare	Barded Nightmare	false
character_skills_localised_name_nag_nagash_all_dummy_agent_actions_vmp_banshee	Dummy	false
character_skills_localised_description_nag_nagash_all_dummy_agent_actions_vmp_banshee	This is because Banshee had changed its agent_type to runesmith from spy	false
