Loc PackedFile	1
key	text	tooltip
building_chains_chain_tooltip_nag_bpyramid_main	Core Chambers of the Black Pyramid	true
building_chains_chain_tooltip_nag_bpyramid_ew2_mortuary	Chambers of the Spirits	true
building_chains_chain_tooltip_nag_bpyramid_ew1_barracks	Chambers of the Beasts	true
building_chains_chain_tooltip_nag_bpyramid_ww1_stables	Chambers of the Vanguard	true
building_chains_chain_tooltip_nag_bpyramid_ww2_warmachines	Chambers of the Machines	true
building_chains_chain_tooltip_nag_bpyramid_military4_monsters	[PH]	true
building_chains_chain_tooltip_nag_bpyramid_support1_smith	[PH]	true
building_chains_chain_tooltip_nag_bpyramid_main_obelisk	Black Obelisk	true
building_chains_chain_tooltip_nag_bpyramid_support3_wizards	[PH]	true
building_chains_chain_tooltip_nag_bpyramid_ew4_other	Pyramid Edges	true
building_chains_chain_tooltip_nag_bpyramid_ww4_extra	Pyramid Edges	true
building_chains_chain_tooltip_nag_bpyramid_ew3_growth	Eastern Passages	true
building_chains_chain_tooltip_nag_bpyramid_ww3_industry	Western Passages	true
building_chains_chain_tooltip_nag_bpyramid_infrastructure3_energy	[PH]	true
building_chains_chain_tooltip_nag_bpyramid_infrastructure4_other	[PH]	true
building_chains_chain_tooltip_nag_outpost_primary_main	Defiled Grounds	true
building_chains_chain_tooltip_nag_outpost_primary_main_coast	Defiled Shores	true
building_chains_chain_tooltip_nag_outpostnorsca_primary_main	Defiled Frozen Grounds	true
building_chains_chain_tooltip_nag_outpostnorsca_primary_main_coast	Defiled Frozen Shores	true
building_chains_chain_tooltip_nag_outpost_main_port	Ferryman's Crossing	true
building_chains_chain_tooltip_nag_outpost_secondary_main	Tainted Grounds	true
building_chains_chain_tooltip_nag_outpost_secondary_main_coast	Tainted Shores	true
building_chains_chain_tooltip_nag_outpostnorsca_secondary_main	Tainted Frozen Grounds	true
building_chains_chain_tooltip_nag_outpostnorsca_secondary_main_coast	Tainted Frozen Shores	true
building_chains_chain_tooltip_nag_outpost_primary_research	Tower of Dhar	true
building_chains_chain_tooltip_nag_outpost_primary_arcane	Conduit of Souls	true
building_chains_chain_tooltip_nag_outpost_primary_support	Mausoleum of the Damned	true
building_chains_chain_tooltip_nag_outpost_primary_nehek	Nehekharan Tombs	true
building_chains_chain_tooltip_nag_outpost_primary_nagashizzar	Ancient Catacombs	true
building_chains_chain_tooltip_nag_outpost_primary_coast	Watery Graves	true
building_chains_chain_tooltip_nag_outpost_primary_count	Stone Crypts	true
building_chains_chain_tooltip_nag_outpost_primary_warpstone	Warpstone Lode	true
building_chains_chain_tooltip_nag_outpost_secondary_fields	Field of Bones	true
building_chains_chain_tooltip_nag_outpost_secondary_corruption	Wellspring of Corruption	true
building_chains_chain_tooltip_nag_outpost_secondary_syphon	Fetid Mire	true
building_chains_chain_tooltip_nag_outpost_secondary_energy	Spirit Siphon	true
building_chains_chain_tooltip_nag_nagash_horde_special	[PH]	true
building_chains_chain_tooltip_nag_arkhan_horde_special	[PH]	true
building_chains_chain_tooltip_nag_vlad_horde_special	[PH]	true
building_chains_chain_tooltip_nag_neffy_horde_special	[PH]	true
building_chains_chain_tooltip_nag_manny_horde_special	[PH]	true
building_chains_chain_tooltip_nag_krell_horde_special	[PH]	true
building_chains_chain_tooltip_nag_luthor_horde_special	[PH]	true
building_chains_chain_tooltip_nag_nagash_horde_landmark	[PH] Nagash Landmark	true
building_chains_chain_tooltip_nag_arkhan_horde_landmark	[PH] Arkhan Landmark	true
building_chains_chain_tooltip_nag_vlad_horde_landmark	[PH]	true
building_chains_chain_tooltip_nag_neffy_horde_landmark	[PH]	true
building_chains_chain_tooltip_nag_manny_horde_landmark	[PH]	true
building_chains_chain_tooltip_nag_krell_horde_landmark	[PH]	true
building_chains_chain_tooltip_nag_luthor_horde_landmark	[PH]	true
building_chains_chain_tooltip_nag_horde_military1_barracks	[PH]	true
building_chains_chain_tooltip_nag_horde_military2_stables	[PH]	true
building_chains_chain_tooltip_nag_horde_military3_warmachines	[PH]	true
building_chains_chain_tooltip_nag_horde_military4_monsters	[PH]	true
building_chains_chain_tooltip_nag_horde_support1_smith	[PH]	true
building_chains_chain_tooltip_nag_horde_support2_worship	[PH]	true
building_chains_chain_tooltip_nag_horde_support3_wizards	[PH]	true
building_chains_chain_tooltip_nag_horde_infrastructure1_growth	[PH]	true
building_chains_chain_tooltip_nag_horde_infrastructure2_industry	[PH]	true
building_chains_chain_tooltip_nag_horde_infrastructure3_energy	[PH]	true
building_chains_chain_tooltip_nag_horde_infrastructure4_other	[PH]	true
building_chains_chain_tooltip_nag_subhorde_main	[PH]	true
building_chains_chain_tooltip_nag_subhorde_military1_barracks	[PH]	true
building_chains_chain_tooltip_nag_subhorde_military2_stables	[PH]	true
building_chains_chain_tooltip_nag_subhorde_military3_warmachines	[PH]	true
building_chains_chain_tooltip_nag_subhorde_military4_monsters	[PH]	true
building_chains_chain_tooltip_nag_subhorde_support2_worship	[PH]	true
building_chains_chain_tooltip_nag_subhorde_infrastructure1_growth	[PH]	true
building_chains_chain_tooltip_nag_subhorde_infrastructure2_industry	[PH]	true
building_chains_chain_tooltip_wh2_dlc09_special_settlement_altdorf_nag	Defiled Grounds	true
building_chains_chain_tooltip_wh2_dlc09_special_settlement_athel_loren_nag	Defiled Grounds	true
building_chains_chain_tooltip_wh2_dlc09_special_settlement_black_crag_nag	Defiled Grounds	true
building_chains_chain_tooltip_wh2_dlc09_special_settlement_castle_drakenhof_nag	Defiled Grounds	true
building_chains_chain_tooltip_wh2_dlc09_special_settlement_couronne_nag	Defiled Grounds	true
building_chains_chain_tooltip_wh2_dlc09_special_settlement_eight_peaks_nag	Defiled Grounds	true
building_chains_chain_tooltip_wh2_dlc09_special_settlement_gaean_vale_nag	Defiled Grounds	true
building_chains_chain_tooltip_wh2_dlc09_special_settlement_hexoatl_nag	Defiled Grounds	true
building_chains_chain_tooltip_wh2_dlc09_special_settlement_itza_nag	Defiled Grounds	true
building_chains_chain_tooltip_wh2_dlc09_special_settlement_karaz_a_karak_nag	Defiled Grounds	true
building_chains_chain_tooltip_wh2_dlc09_special_settlement_khemri_nag	Defiled Grounds	true
building_chains_chain_tooltip_wh2_dlc09_special_settlement_kislev_nag	Defiled Grounds	true
building_chains_chain_tooltip_wh2_dlc09_special_settlement_konquata_nag	Defiled Grounds	true
building_chains_chain_tooltip_wh2_dlc09_special_settlement_lahmia_nag	Defiled Grounds	true
building_chains_chain_tooltip_wh2_dlc09_special_settlement_lothern_nag	Defiled Shores	true
building_chains_chain_tooltip_wh2_dlc09_special_settlement_miragliano_nag	Defiled Shores	true
building_chains_chain_tooltip_wh2_dlc09_special_settlement_naggarond_nag	Defiled Shores	true
building_chains_chain_tooltip_wh2_dlc09_special_settlement_pyramid_of_nagash_nag	The Great Mortis River	true
building_chains_chain_tooltip_wh2_dlc15_special_morgheim_necropolis_nag	Ancient Ruins	true
building_chains_chain_tooltip_wh2_dlc15_special_settlement_massif_orcal_nag	Defiled Grounds	true
building_chains_chain_tooltip_wh2_dlc15_special_settlement_tor_yvresse_nag	Defiled Shores	true
building_chains_chain_tooltip_wh2_main_special_galbaraz_mourkain_nag	Ancient Ruins	true
building_chains_chain_tooltip_wh2_main_special_settlement_sartosa_nag	Defiled Shores	true
building_chains_chain_tooltip_wh2_main_special_settlement_the_awakening_nag	Defiled Shores	true
building_chains_chain_tooltip_wh2_dlc11_special_settlement_galleons_graveyard_nag	Defiled Shores	true
building_chains_chain_tooltip_wh2_main_special_settlement_hellpit_nag	Defiled Grounds	true
building_chains_chain_tooltip_wh2_main_special_settlement_skavenblight_nag	Defiled Grounds	true
building_chains_chain_tooltip_wh2_main_special_empire_fort_nag	Defiled Grounds	true
building_chains_chain_tooltip_wh2_main_special_fortress_gate_eagle_nag	Defiled Grounds	true
building_chains_chain_tooltip_wh2_main_special_fortress_gate_griffon_nag	Defiled Grounds	true
building_chains_chain_tooltip_wh2_main_special_fortress_gate_phoenix_nag	Defiled Grounds	true
building_chains_chain_tooltip_wh2_main_special_fortress_gate_unicorn_nag	Defiled Grounds	true
building_chains_chain_tooltip_wh2_main_special_settlement_colony_major_nag	Defiled Grounds	true
building_chains_chain_tooltip_wh2_main_special_settlement_colony_minor_nag	Defiled Grounds	true
building_chains_chain_tooltip_wh_dlc05_wef_oak_of_ages_nag	Dhar Empowered Ogham Stones	true
building_chains_chain_tooltip_wh2_twa03_special_ogham_stones_nag	Ruined Ogham Stones	true
building_chains_chain_tooltip_wh2_dlc14_special_dragon_isle_port_nag	Ferryman's Crossing	true
building_chains_chain_tooltip_wh2_dlc14_special_copher_port_nag	Ferryman's Crossing	true
building_chains_chain_tooltip_wh_main_bretonnia_legendary_bordeleaux_nag	Ferryman's Crossing	true
building_chains_chain_tooltip_wh_main_special_erengrad_port_nag	Ferryman's Crossing	true
building_chains_chain_tooltip_wh_main_special_marienburg_port_nag	Ferryman's Crossing	true
building_chains_chain_tooltip_wh_twa03_special_albion_port_nag	Ferryman's Crossing	true
