from	to
#building_downgrade_junctions_tables;0;db/building_downgrade_junctions_tables/jvj_nagash_buildings_outpost	
nag_outpost_primary_main_ruin	nag_outpost_primary_main_ruin
nag_outpost_primary_main_1	nag_outpost_primary_main_1
nag_outpost_primary_main_2	nag_outpost_primary_main_2
nag_outpost_primary_main_3	nag_outpost_primary_main_3
nag_outpost_primary_main_4	nag_outpost_primary_main_4
nag_outpost_primary_main_5	nag_outpost_primary_main_5
nag_outpost_primary_main_coast_ruin	nag_outpost_primary_main_coast_ruin
nag_outpost_primary_main_coast_1	nag_outpost_primary_main_coast_1
nag_outpost_primary_main_coast_2	nag_outpost_primary_main_coast_2
nag_outpost_primary_main_coast_3	nag_outpost_primary_main_coast_3
nag_outpost_primary_main_coast_4	nag_outpost_primary_main_coast_4
nag_outpost_primary_main_coast_5	nag_outpost_primary_main_coast_5
nag_outpost_norsca_primary_main_ruin	nag_outpost_norsca_primary_main_ruin
nag_outpost_norsca_primary_main_1	nag_outpost_norsca_primary_main_1
nag_outpost_norsca_primary_main_2	nag_outpost_norsca_primary_main_2
nag_outpost_norsca_primary_main_3	nag_outpost_norsca_primary_main_3
nag_outpost_norsca_primary_main_4	nag_outpost_norsca_primary_main_4
nag_outpost_norsca_primary_main_5	nag_outpost_norsca_primary_main_5
nag_outpost_norsca_primary_main_coast_ruin	nag_outpost_norsca_primary_main_coast_ruin
nag_outpost_norsca_primary_main_coast_1	nag_outpost_norsca_primary_main_coast_1
nag_outpost_norsca_primary_main_coast_2	nag_outpost_norsca_primary_main_coast_2
nag_outpost_norsca_primary_main_coast_3	nag_outpost_norsca_primary_main_coast_3
nag_outpost_norsca_primary_main_coast_4	nag_outpost_norsca_primary_main_coast_4
nag_outpost_norsca_primary_main_coast_5	nag_outpost_norsca_primary_main_coast_5
nag_outpost_secondary_main_ruin	nag_outpost_secondary_main_ruin
nag_outpost_secondary_main_1	nag_outpost_secondary_main_1
nag_outpost_secondary_main_coast_ruin	nag_outpost_secondary_main_coast_ruin
nag_outpost_secondary_main_coast_1	nag_outpost_secondary_main_coast_1
nag_outpost_norsca_secondary_main_ruin	nag_outpost_norsca_secondary_main_ruin
nag_outpost_norsca_secondary_main_1	nag_outpost_norsca_secondary_main_1
nag_outpost_norsca_secondary_main_coast_1	nag_outpost_norsca_secondary_main_coast_1
nag_outpost_norsca_secondary_coast_main_ruin	nag_outpost_norsca_secondary_coast_main_ruin
nag_outpost_main_port_ruin	nag_outpost_main_port_ruin
nag_outpost_main_port_1	nag_outpost_main_port_1
nag_outpost_primary_main_altdorf_ruin	nag_outpost_primary_main_altdorf_ruin
nag_outpost_primary_main_altdorf_1	nag_outpost_primary_main_altdorf_1
nag_outpost_primary_main_altdorf_2	nag_outpost_primary_main_altdorf_2
nag_outpost_primary_main_altdorf_3	nag_outpost_primary_main_altdorf_3
nag_outpost_primary_main_altdorf_4	nag_outpost_primary_main_altdorf_4
nag_outpost_primary_main_altdorf_5	nag_outpost_primary_main_altdorf_5
nag_outpost_primary_main_athel_loren_ruin	nag_outpost_primary_main_athel_loren_ruin
nag_outpost_primary_main_athel_loren_1	nag_outpost_primary_main_athel_loren_1
nag_outpost_primary_main_athel_loren_2	nag_outpost_primary_main_athel_loren_2
nag_outpost_primary_main_athel_loren_3	nag_outpost_primary_main_athel_loren_3
nag_outpost_primary_main_athel_loren_4	nag_outpost_primary_main_athel_loren_4
nag_outpost_primary_main_athel_loren_5	nag_outpost_primary_main_athel_loren_5
nag_outpost_primary_main_black_crag_ruin	nag_outpost_primary_main_black_crag_ruin
nag_outpost_primary_main_black_crag_1	nag_outpost_primary_main_black_crag_1
nag_outpost_primary_main_black_crag_2	nag_outpost_primary_main_black_crag_2
nag_outpost_primary_main_black_crag_3	nag_outpost_primary_main_black_crag_3
nag_outpost_primary_main_black_crag_4	nag_outpost_primary_main_black_crag_4
nag_outpost_primary_main_black_crag_5	nag_outpost_primary_main_black_crag_5
nag_outpost_primary_main_castle_drakenhof_ruin	nag_outpost_primary_main_castle_drakenhof_ruin
nag_outpost_primary_main_castle_drakenhof_1	nag_outpost_primary_main_castle_drakenhof_1
nag_outpost_primary_main_castle_drakenhof_2	nag_outpost_primary_main_castle_drakenhof_2
nag_outpost_primary_main_castle_drakenhof_3	nag_outpost_primary_main_castle_drakenhof_3
nag_outpost_primary_main_castle_drakenhof_4	nag_outpost_primary_main_castle_drakenhof_4
nag_outpost_primary_main_castle_drakenhof_5	nag_outpost_primary_main_castle_drakenhof_5
nag_outpost_primary_main_couronne_ruin	nag_outpost_primary_main_couronne_ruin
nag_outpost_primary_main_couronne_1	nag_outpost_primary_main_couronne_1
nag_outpost_primary_main_couronne_2	nag_outpost_primary_main_couronne_2
nag_outpost_primary_main_couronne_3	nag_outpost_primary_main_couronne_3
nag_outpost_primary_main_couronne_4	nag_outpost_primary_main_couronne_4
nag_outpost_primary_main_couronne_5	nag_outpost_primary_main_couronne_5
nag_outpost_primary_main_eight_peaks_ruin	nag_outpost_primary_main_eight_peaks_ruin
nag_outpost_primary_main_eight_peaks_1	nag_outpost_primary_main_eight_peaks_1
nag_outpost_primary_main_eight_peaks_2	nag_outpost_primary_main_eight_peaks_2
nag_outpost_primary_main_eight_peaks_3	nag_outpost_primary_main_eight_peaks_3
nag_outpost_primary_main_eight_peaks_4	nag_outpost_primary_main_eight_peaks_4
nag_outpost_primary_main_eight_peaks_5	nag_outpost_primary_main_eight_peaks_5
nag_outpost_primary_main_gaean_vale_ruin	nag_outpost_primary_main_gaean_vale_ruin
nag_outpost_primary_main_gaean_vale_1	nag_outpost_primary_main_gaean_vale_1
nag_outpost_primary_main_gaean_vale_2	nag_outpost_primary_main_gaean_vale_2
nag_outpost_primary_main_gaean_vale_3	nag_outpost_primary_main_gaean_vale_3
nag_outpost_primary_main_gaean_vale_4	nag_outpost_primary_main_gaean_vale_4
nag_outpost_primary_main_gaean_vale_5	nag_outpost_primary_main_gaean_vale_5
nag_outpost_primary_main_hexoatl_ruin	nag_outpost_primary_main_hexoatl_ruin
nag_outpost_primary_main_hexoatl_1	nag_outpost_primary_main_hexoatl_1
nag_outpost_primary_main_hexoatl_2	nag_outpost_primary_main_hexoatl_2
nag_outpost_primary_main_hexoatl_3	nag_outpost_primary_main_hexoatl_3
nag_outpost_primary_main_hexoatl_4	nag_outpost_primary_main_hexoatl_4
nag_outpost_primary_main_hexoatl_5	nag_outpost_primary_main_hexoatl_5
nag_outpost_primary_main_itza_ruin	nag_outpost_primary_main_itza_ruin
nag_outpost_primary_main_itza_1	nag_outpost_primary_main_itza_1
nag_outpost_primary_main_itza_2	nag_outpost_primary_main_itza_2
nag_outpost_primary_main_itza_3	nag_outpost_primary_main_itza_3
nag_outpost_primary_main_itza_4	nag_outpost_primary_main_itza_4
nag_outpost_primary_main_itza_5	nag_outpost_primary_main_itza_5
nag_outpost_primary_main_karaz_a_karak_ruin	nag_outpost_primary_main_karaz_a_karak_ruin
nag_outpost_primary_main_karaz_a_karak_1	nag_outpost_primary_main_karaz_a_karak_1
nag_outpost_primary_main_karaz_a_karak_2	nag_outpost_primary_main_karaz_a_karak_2
nag_outpost_primary_main_karaz_a_karak_3	nag_outpost_primary_main_karaz_a_karak_3
nag_outpost_primary_main_karaz_a_karak_4	nag_outpost_primary_main_karaz_a_karak_4
nag_outpost_primary_main_karaz_a_karak_5	nag_outpost_primary_main_karaz_a_karak_5
nag_outpost_primary_main_khemri_ruin	nag_outpost_primary_main_khemri_ruin
nag_outpost_primary_main_khemri_1	nag_outpost_primary_main_khemri_1
nag_outpost_primary_main_khemri_2	nag_outpost_primary_main_khemri_2
nag_outpost_primary_main_khemri_3	nag_outpost_primary_main_khemri_3
nag_outpost_primary_main_khemri_4	nag_outpost_primary_main_khemri_4
nag_outpost_primary_main_khemri_5	nag_outpost_primary_main_khemri_5
nag_outpost_primary_main_kislev_ruin	nag_outpost_primary_main_kislev_ruin
nag_outpost_primary_main_kislev_1	nag_outpost_primary_main_kislev_1
nag_outpost_primary_main_kislev_2	nag_outpost_primary_main_kislev_2
nag_outpost_primary_main_kislev_3	nag_outpost_primary_main_kislev_3
nag_outpost_primary_main_kislev_4	nag_outpost_primary_main_kislev_4
nag_outpost_primary_main_kislev_5	nag_outpost_primary_main_kislev_5
nag_outpost_primary_main_konquata_ruin	nag_outpost_primary_main_konquata_ruin
nag_outpost_primary_main_konquata_1	nag_outpost_primary_main_konquata_1
nag_outpost_primary_main_konquata_2	nag_outpost_primary_main_konquata_2
nag_outpost_primary_main_konquata_3	nag_outpost_primary_main_konquata_3
nag_outpost_primary_main_konquata_4	nag_outpost_primary_main_konquata_4
nag_outpost_primary_main_konquata_5	nag_outpost_primary_main_konquata_5
nag_outpost_primary_main_lahmia_ruin	nag_outpost_primary_main_lahmia_ruin
nag_outpost_primary_main_lahmia_1	nag_outpost_primary_main_lahmia_1
nag_outpost_primary_main_lahmia_2	nag_outpost_primary_main_lahmia_2
nag_outpost_primary_main_lahmia_3	nag_outpost_primary_main_lahmia_3
nag_outpost_primary_main_lahmia_4	nag_outpost_primary_main_lahmia_4
nag_outpost_primary_main_lahmia_5	nag_outpost_primary_main_lahmia_5
nag_outpost_primary_main_lothern_ruin	nag_outpost_primary_main_lothern_ruin
nag_outpost_primary_main_lothern_1	nag_outpost_primary_main_lothern_1
nag_outpost_primary_main_lothern_2	nag_outpost_primary_main_lothern_2
nag_outpost_primary_main_lothern_3	nag_outpost_primary_main_lothern_3
nag_outpost_primary_main_lothern_4	nag_outpost_primary_main_lothern_4
nag_outpost_primary_main_lothern_5	nag_outpost_primary_main_lothern_5
nag_outpost_primary_main_miragliano_ruin	nag_outpost_primary_main_miragliano_ruin
nag_outpost_primary_main_miragliano_1	nag_outpost_primary_main_miragliano_1
nag_outpost_primary_main_miragliano_2	nag_outpost_primary_main_miragliano_2
nag_outpost_primary_main_miragliano_3	nag_outpost_primary_main_miragliano_3
nag_outpost_primary_main_miragliano_4	nag_outpost_primary_main_miragliano_4
nag_outpost_primary_main_miragliano_5	nag_outpost_primary_main_miragliano_5
nag_outpost_primary_main_naggarond_ruin	nag_outpost_primary_main_naggarond_ruin
nag_outpost_primary_main_naggarond_1	nag_outpost_primary_main_naggarond_1
nag_outpost_primary_main_naggarond_2	nag_outpost_primary_main_naggarond_2
nag_outpost_primary_main_naggarond_3	nag_outpost_primary_main_naggarond_3
nag_outpost_primary_main_naggarond_4	nag_outpost_primary_main_naggarond_4
nag_outpost_primary_main_naggarond_5	nag_outpost_primary_main_naggarond_5
nag_outpost_primary_main_pyramid_of_nagash_ruin	nag_outpost_primary_main_pyramid_of_nagash_ruin
nag_outpost_primary_main_pyramid_of_nagash_1	nag_outpost_primary_main_pyramid_of_nagash_1
nag_outpost_primary_main_pyramid_of_nagash_2	nag_outpost_primary_main_pyramid_of_nagash_2
nag_outpost_primary_main_pyramid_of_nagash_3	nag_outpost_primary_main_pyramid_of_nagash_3
nag_outpost_primary_main_pyramid_of_nagash_4	nag_outpost_primary_main_pyramid_of_nagash_4
nag_outpost_primary_main_pyramid_of_nagash_5	nag_outpost_primary_main_pyramid_of_nagash_5
nag_outpost_primary_main_massif_orcal_ruin	nag_outpost_primary_main_massif_orcal_ruin
nag_outpost_primary_main_massif_orcal_1	nag_outpost_primary_main_massif_orcal_1
nag_outpost_primary_main_massif_orcal_2	nag_outpost_primary_main_massif_orcal_2
nag_outpost_primary_main_massif_orcal_3	nag_outpost_primary_main_massif_orcal_3
nag_outpost_primary_main_massif_orcal_4	nag_outpost_primary_main_massif_orcal_4
nag_outpost_primary_main_massif_orcal_5	nag_outpost_primary_main_massif_orcal_5
nag_outpost_primary_main_tor_yvresse_ruin	nag_outpost_primary_main_tor_yvresse_ruin
nag_outpost_primary_main_tor_yvresse_1	nag_outpost_primary_main_tor_yvresse_1
nag_outpost_primary_main_tor_yvresse_2	nag_outpost_primary_main_tor_yvresse_2
nag_outpost_primary_main_tor_yvresse_3	nag_outpost_primary_main_tor_yvresse_3
nag_outpost_primary_main_tor_yvresse_4	nag_outpost_primary_main_tor_yvresse_4
nag_outpost_primary_main_tor_yvresse_5	nag_outpost_primary_main_tor_yvresse_5
nag_outpost_primary_main_sartosa_ruin	nag_outpost_primary_main_sartosa_ruin
nag_outpost_primary_main_sartosa_1	nag_outpost_primary_main_sartosa_1
nag_outpost_primary_main_sartosa_2	nag_outpost_primary_main_sartosa_2
nag_outpost_primary_main_sartosa_3	nag_outpost_primary_main_sartosa_3
nag_outpost_primary_main_sartosa_4	nag_outpost_primary_main_sartosa_4
nag_outpost_primary_main_sartosa_5	nag_outpost_primary_main_sartosa_5
nag_outpost_primary_main_the_awakening_ruin	nag_outpost_primary_main_the_awakening_ruin
nag_outpost_primary_main_the_awakening_1	nag_outpost_primary_main_the_awakening_1
nag_outpost_primary_main_the_awakening_2	nag_outpost_primary_main_the_awakening_2
nag_outpost_primary_main_the_awakening_3	nag_outpost_primary_main_the_awakening_3
nag_outpost_primary_main_the_awakening_4	nag_outpost_primary_main_the_awakening_4
nag_outpost_primary_main_the_awakening_5	nag_outpost_primary_main_the_awakening_5
nag_outpost_primary_main_galleons_graveyard_ruin	nag_outpost_primary_main_galleons_graveyard_ruin
nag_outpost_primary_main_galleons_graveyard_1	nag_outpost_primary_main_galleons_graveyard_1
nag_outpost_primary_main_galleons_graveyard_2	nag_outpost_primary_main_galleons_graveyard_2
nag_outpost_primary_main_galleons_graveyard_3	nag_outpost_primary_main_galleons_graveyard_3
nag_outpost_primary_main_galleons_graveyard_4	nag_outpost_primary_main_galleons_graveyard_4
nag_outpost_primary_main_galleons_graveyard_5	nag_outpost_primary_main_galleons_graveyard_5
nag_outpost_primary_main_hellpit_ruin	nag_outpost_primary_main_hellpit_ruin
nag_outpost_primary_main_hellpit_1	nag_outpost_primary_main_hellpit_1
nag_outpost_primary_main_hellpit_2	nag_outpost_primary_main_hellpit_2
nag_outpost_primary_main_hellpit_3	nag_outpost_primary_main_hellpit_3
nag_outpost_primary_main_hellpit_4	nag_outpost_primary_main_hellpit_4
nag_outpost_primary_main_hellpit_5	nag_outpost_primary_main_hellpit_5
nag_outpost_primary_main_skavenblight_ruin	nag_outpost_primary_main_skavenblight_ruin
nag_outpost_primary_main_skavenblight_1	nag_outpost_primary_main_skavenblight_1
nag_outpost_primary_main_skavenblight_2	nag_outpost_primary_main_skavenblight_2
nag_outpost_primary_main_skavenblight_3	nag_outpost_primary_main_skavenblight_3
nag_outpost_primary_main_skavenblight_4	nag_outpost_primary_main_skavenblight_4
nag_outpost_primary_main_skavenblight_5	nag_outpost_primary_main_skavenblight_5
nag_outpost_primary_main_empire_fort_ruin	nag_outpost_primary_main_empire_fort_ruin
nag_outpost_primary_main_empire_fort_1	nag_outpost_primary_main_empire_fort_1
nag_outpost_primary_main_empire_fort_2	nag_outpost_primary_main_empire_fort_2
nag_outpost_primary_main_empire_fort_3	nag_outpost_primary_main_empire_fort_3
nag_outpost_primary_main_empire_fort_4	nag_outpost_primary_main_empire_fort_4
nag_outpost_primary_main_empire_fort_5	nag_outpost_primary_main_empire_fort_5
nag_outpost_primary_main_fortress_gate_eagle_ruin	nag_outpost_primary_main_fortress_gate_eagle_ruin
nag_outpost_primary_main_fortress_gate_eagle_1	nag_outpost_primary_main_fortress_gate_eagle_1
nag_outpost_primary_main_fortress_gate_eagle_2	nag_outpost_primary_main_fortress_gate_eagle_2
nag_outpost_primary_main_fortress_gate_eagle_3	nag_outpost_primary_main_fortress_gate_eagle_3
nag_outpost_primary_main_fortress_gate_eagle_4	nag_outpost_primary_main_fortress_gate_eagle_4
nag_outpost_primary_main_fortress_gate_eagle_5	nag_outpost_primary_main_fortress_gate_eagle_5
nag_outpost_primary_main_fortress_gate_griffon_ruin	nag_outpost_primary_main_fortress_gate_griffon_ruin
nag_outpost_primary_main_fortress_gate_griffon_1	nag_outpost_primary_main_fortress_gate_griffon_1
nag_outpost_primary_main_fortress_gate_griffon_2	nag_outpost_primary_main_fortress_gate_griffon_2
nag_outpost_primary_main_fortress_gate_griffon_3	nag_outpost_primary_main_fortress_gate_griffon_3
nag_outpost_primary_main_fortress_gate_griffon_4	nag_outpost_primary_main_fortress_gate_griffon_4
nag_outpost_primary_main_fortress_gate_griffon_5	nag_outpost_primary_main_fortress_gate_griffon_5
nag_outpost_primary_main_fortress_gate_phoenix_ruin	nag_outpost_primary_main_fortress_gate_phoenix_ruin
nag_outpost_primary_main_fortress_gate_phoenix_1	nag_outpost_primary_main_fortress_gate_phoenix_1
nag_outpost_primary_main_fortress_gate_phoenix_2	nag_outpost_primary_main_fortress_gate_phoenix_2
nag_outpost_primary_main_fortress_gate_phoenix_3	nag_outpost_primary_main_fortress_gate_phoenix_3
nag_outpost_primary_main_fortress_gate_phoenix_4	nag_outpost_primary_main_fortress_gate_phoenix_4
nag_outpost_primary_main_fortress_gate_phoenix_5	nag_outpost_primary_main_fortress_gate_phoenix_5
nag_outpost_primary_main_fortress_gate_unicorn_ruin	nag_outpost_primary_main_fortress_gate_unicorn_ruin
nag_outpost_primary_main_fortress_gate_unicorn_1	nag_outpost_primary_main_fortress_gate_unicorn_1
nag_outpost_primary_main_fortress_gate_unicorn_2	nag_outpost_primary_main_fortress_gate_unicorn_2
nag_outpost_primary_main_fortress_gate_unicorn_3	nag_outpost_primary_main_fortress_gate_unicorn_3
nag_outpost_primary_main_fortress_gate_unicorn_4	nag_outpost_primary_main_fortress_gate_unicorn_4
nag_outpost_primary_main_fortress_gate_unicorn_5	nag_outpost_primary_main_fortress_gate_unicorn_5
nag_outpost_primary_main_elven_colony_ruin	nag_outpost_primary_main_elven_colony_ruin
nag_outpost_primary_main_elven_colony_1	nag_outpost_primary_main_elven_colony_1
nag_outpost_primary_main_elven_colony_2	nag_outpost_primary_main_elven_colony_2
nag_outpost_primary_main_elven_colony_3	nag_outpost_primary_main_elven_colony_3
nag_outpost_primary_main_elven_colony_4	nag_outpost_primary_main_elven_colony_4
nag_outpost_primary_main_elven_colony_5	nag_outpost_primary_main_elven_colony_5
nag_outpost_primary_main_elven_colony_minor_1	nag_outpost_primary_main_elven_colony_minor_1
nag_outpost_primary_main_elven_colony_minor_ruin	nag_outpost_primary_main_elven_colony_minor_ruin
nag_outpost_primary_main_oak_of_ages_ruin	nag_outpost_primary_main_oak_of_ages_ruin
nag_outpost_primary_main_oak_of_ages_1	nag_outpost_primary_main_oak_of_ages_1
nag_outpost_landmark_copher_port_1	nag_outpost_landmark_copher_port_1
nag_outpost_landmark_copher_port_ruin	nag_outpost_landmark_copher_port_ruin
nag_outpost_landmark_bordeleaux_port_1	nag_outpost_landmark_bordeleaux_port_1
nag_outpost_landmark_bordeleaux_port_ruin	nag_outpost_landmark_bordeleaux_port_ruin
nag_outpost_landmark_dragon_isle_port_1	nag_outpost_landmark_dragon_isle_port_1
nag_outpost_landmark_dragon_isle_port_ruin	nag_outpost_landmark_dragon_isle_port_ruin
nag_outpost_landmark_lothern_port_1	nag_outpost_landmark_lothern_port_1
nag_outpost_landmark_lothern_port_ruin	nag_outpost_landmark_lothern_port_ruin
nag_outpost_landmark_erengrad_port_1	nag_outpost_landmark_erengrad_port_1
nag_outpost_landmark_erengrad_port_ruin	nag_outpost_landmark_erengrad_port_ruin
nag_outpost_landmark_marienburg_port_1	nag_outpost_landmark_marienburg_port_1
nag_outpost_landmark_marienburg_port_ruin	nag_outpost_landmark_marienburg_port_ruin
nag_outpost_landmark_albion_port_1	nag_outpost_landmark_albion_port_1
nag_outpost_landmark_albion_port_ruin	nag_outpost_landmark_albion_port_ruin
